Donor Age,Donor State of Residence,Donor Ethnicity,All Donors - All Donor Types,All Donors - Deceased Donor,All Donors - Living Donor,Kidney - All Donor Types,Kidney - Deceased Donor,Kidney - Living Donor,Liver - All Donor Types,Liver - Deceased Donor,Liver - Living Donor,Heart - All Donor Types,Heart - Deceased Donor,Heart - Living Donor,Pancreas - All Donor Types,Pancreas - Deceased Donor,Pancreas - Living Donor,Lung - All Donor Types,Lung - Deceased Donor,Lung - Living Donor,Intestine - All Donor Types,Intestine - Deceased Donor,Intestine - Living Donor
All Ages,All Donor States of Residence,All Ethnicities,387089,222013,165076,360646,203365,157281,187160,179950,7210,78109,78066,43,46574,46502,72,39849,39371,478,3430,3386,44
,,White,273107,156216,116891,255889,145100,110789,130749,125159,5590,53987,53945,42,33376,33316,60,26230,25807,423,2171,2145,26
,,Black,50384,31290,19094,45451,26758,18693,27195,26810,385,10963,10963,0,6477,6472,5,6678,6672,6,664,655,9
,,Hispanic,47857,26660,21197,44589,24351,20238,22462,21550,912,10972,10971,1,5393,5389,4,5409,5370,39,485,476,9
,,Unknown,328,217,111,309,201,108,169,167,2,83,83,0,52,51,1,21,20,1,4,4,0
,,Asian,9780,4645,5135,9150,4244,4906,4037,3815,222,1153,1153,0,710,708,2,983,976,7,55,55,0
,,American Indian/Alaska Native,1736,872,864,1661,817,844,677,657,20,345,345,0,198,198,0,162,162,0,13,13,0
,,Pacific Islander,1248,530,718,1188,488,700,445,429,16,121,121,0,90,90,0,87,85,2,4,4,0
,,Multiracial,2649,1583,1066,2409,1406,1003,1426,1363,63,485,485,0,278,278,0,279,279,0,34,34,0
,Alabama,All Ethnicities,6338,3750,2588,6014,3452,2562,3111,3091,20,1193,1191,2,603,602,1,572,569,3,36,36,0
,,White,4714,2800,1914,4510,2621,1889,2290,2271,19,881,879,2,441,440,1,401,398,3,24,24,0
,,Black,1494,874,620,1379,760,619,760,759,1,275,275,0,150,150,0,158,158,0,9,9,0
,,Hispanic,72,42,30,70,40,30,35,35,0,25,25,0,7,7,0,8,8,0,2,2,0
,,Unknown,2,2,0,2,2,0,1,1,0,0,0,0,0,0,0,0,0,0,0,0,0
,,Asian,40,22,18,38,20,18,17,17,0,7,7,0,4,4,0,3,3,0,1,1,0
,,American Indian/Alaska Native,5,2,3,5,2,3,1,1,0,1,1,0,1,1,0,0,0,0,0,0,0
,,Pacific Islander,1,1,0,0,0,0,1,1,0,1,1,0,0,0,0,0,0,0,0,0,0
,,Multiracial,10,7,3,10,7,3,6,6,0,3,3,0,0,0,0,2,2,0,0,0,0
,Alaska,All Ethnicities,1008,622,386,979,604,375,499,490,9,210,209,1,150,150,0,129,128,1,1,1,0
,,White,770,453,317,745,437,308,364,357,7,155,154,1,107,107,0,95,94,1,0,0,0
,,Black,40,23,17,39,23,16,21,20,1,7,7,0,8,8,0,6,6,0,0,0,0
,,Hispanic,21,14,7,20,13,7,11,11,0,7,7,0,2,2,0,2,2,0,0,0,0
,,Asian,25,20,5,24,20,4,17,16,1,7,7,0,3,3,0,7,7,0,0,0,0
,,American Indian/Alaska Native,135,104,31,134,103,31,78,78,0,32,32,0,29,29,0,17,17,0,1,1,0
,,Pacific Islander,10,5,5,10,5,5,5,5,0,0,0,0,0,0,0,2,2,0,0,0,0
,,Multiracial,7,3,4,7,3,4,3,3,0,2,2,0,1,1,0,0,0,0,0,0,0
,Arizona,All Ethnicities,7007,3771,3236,6666,3593,3073,3242,3106,136,1341,1339,2,687,687,0,754,729,25,45,45,0
,,White,4802,2598,2204,4557,2485,2072,2222,2115,107,886,884,2,451,451,0,492,469,23,23,23,0
,,Black,331,196,135,304,172,132,177,174,3,66,66,0,30,30,0,43,43,0,1,1,0
,,Hispanic,1516,832,684,1453,795,658,730,706,24,331,331,0,184,184,0,184,182,2,19,19,0
,,Unknown,2,2,0,2,2,0,1,1,0,0,0,0,1,1,0,0,0,0,0,0,0
,,Asian,101,42,59,99,41,58,40,39,1,18,18,0,7,7,0,13,13,0,0,0,0
,,American Indian/Alaska Native,192,72,120,188,69,119,48,47,1,25,25,0,10,10,0,18,18,0,1,1,0
,,Pacific Islander,14,5,9,14,5,9,3,3,0,1,1,0,0,0,0,0,0,0,0,0,0
,,Multiracial,49,24,25,49,24,25,21,21,0,14,14,0,4,4,0,4,4,0,1,1,0
,Arkansas,All Ethnicities,3121,2056,1065,2938,1905,1033,1766,1741,25,811,811,0,419,418,1,372,366,6,56,56,0
,,White,2534,1667,867,2410,1573,837,1436,1413,23,651,651,0,339,338,1,293,287,6,42,42,0
,,Black,469,308,161,417,257,160,268,267,1,127,127,0,64,64,0,67,67,0,13,13,0
,,Hispanic,79,59,20,74,54,20,42,42,0,23,23,0,14,14,0,8,8,0,1,1,0
,,Asian,22,12,10,20,11,9,13,12,1,5,5,0,2,2,0,3,3,0,0,0,0
,,American Indian/Alaska Native,4,2,2,4,2,2,2,2,0,0,0,0,0,0,0,1,1,0,0,0,0
,,Pacific Islander,6,4,2,6,4,2,4,4,0,1,1,0,0,0,0,0,0,0,0,0,0
,,,,,,,,,,,,,,,,,,,,,,,
,,,,,,,,,,,,,,,,,,,,,,,
,,Multiracial,7,4,3,7,4,3,1,1,0,4,4,0,0,0,0,0,0,0,0,0,0
,California,All Ethnicities,39248,22206,17042,36774,20749,16025,18905,18029,876,8565,8556,9,4222,4221,1,4479,4350,129,158,156,2
,,White,20287,11407,8880,19063,10776,8287,9630,9150,480,4227,4219,8,2121,2121,0,1994,1890,104,57,56,1
,,Black,3080,1926,1154,2855,1736,1119,1702,1671,31,725,725,0,371,370,1,435,433,2,17,16,1
,,Hispanic,11956,6886,5070,11179,6403,4776,5831,5558,273,3072,3071,1,1453,1453,0,1615,1595,20,72,72,0
,,Unknown,11,9,2,9,7,2,8,8,0,4,4,0,2,2,0,2,2,0,0,0,0
,,Asian,2967,1527,1440,2766,1407,1359,1345,1266,79,375,375,0,200,200,0,339,337,2,9,9,0
,,American Indian/Alaska Native,127,76,51,122,71,51,55,55,0,33,33,0,16,16,0,16,16,0,1,1,0
,,Pacific Islander,395,139,256,376,125,251,119,115,4,42,42,0,21,21,0,39,38,1,1,1,0
,,Multiracial,425,236,189,404,224,180,215,206,9,87,87,0,38,38,0,39,39,0,1,1,0
,Colorado,All Ethnicities,5736,2937,2799,5354,2753,2601,2596,2404,192,1210,1210,0,756,756,0,494,489,5,42,41,1
,,White,4480,2284,2196,4193,2159,2034,2024,1867,157,945,945,0,612,612,0,378,374,4,33,32,1
,,Black,246,149,97,218,125,93,139,135,4,64,64,0,34,34,0,34,34,0,0,0,0
,,Hispanic,852,424,428,797,397,400,362,335,27,174,174,0,101,101,0,67,66,1,8,8,0
,,Unknown,2,1,1,2,1,1,1,1,0,1,1,0,0,0,0,0,0,0,0,0,0
,,Asian,99,56,43,94,52,42,48,47,1,13,13,0,6,6,0,8,8,0,0,0,0
,,American Indian/Alaska Native,30,21,9,27,18,9,17,17,0,13,13,0,3,3,0,7,7,0,1,1,0
,,Pacific Islander,8,2,6,7,1,6,2,2,0,0,0,0,0,0,0,0,0,0,0,0,0
,,Multiracial,19,0,19,16,0,16,3,0,3,0,0,0,0,0,0,0,0,0,0,0,0
,Connecticut,All Ethnicities,4061,1966,2095,3821,1846,1975,1664,1546,118,725,725,0,354,353,1,273,271,2,21,21,0
,,White,3112,1474,1638,2936,1403,1533,1230,1127,103,515,515,0,251,250,1,186,184,2,11,11,0
,,Black,378,194,184,350,171,179,173,168,5,71,71,0,35,35,0,32,32,0,3,3,0
,,Hispanic,470,260,210,440,238,202,229,221,8,120,120,0,59,59,0,45,45,0,6,6,0
,,Unknown,2,2,0,2,2,0,0,0,0,2,2,0,1,1,0,0,0,0,0,0,0
,,Asian,64,22,42,61,21,40,21,19,2,10,10,0,5,5,0,6,6,0,0,0,0
,,American Indian/Alaska Native,5,3,2,5,3,2,2,2,0,2,2,0,2,2,0,2,2,0,0,0,0
,,Pacific Islander,6,1,5,6,1,5,0,0,0,1,1,0,0,0,0,0,0,0,0,0,0
,,Multiracial,24,10,14,21,7,14,9,9,0,4,4,0,1,1,0,2,2,0,1,1,0
,Delaware,All Ethnicities,1499,1027,472,1386,940,446,857,831,26,328,328,0,204,203,1,199,199,0,13,13,0
,,White,1161,805,356,1090,754,336,655,635,20,251,251,0,147,146,1,143,143,0,5,5,0
,,Black,259,164,95,223,133,90,152,147,5,52,52,0,38,38,0,40,40,0,6,6,0
,,Hispanic,53,41,12,50,38,12,35,35,0,19,19,0,14,14,0,11,11,0,1,1,0
,,Asian,20,13,7,17,11,6,11,10,1,3,3,0,2,2,0,3,3,0,0,0,0
,,American Indian/Alaska Native,1,0,1,1,0,1,0,0,0,0,0,0,0,0,0,0,0,0,0,0,0
,,Pacific Islander,1,0,1,1,0,1,0,0,0,0,0,0,0,0,0,0,0,0,0,0,0
,,Multiracial,4,4,0,4,4,0,4,4,0,3,3,0,3,3,0,2,2,0,1,1,0
,District of Columbia,All Ethnicities,1034,560,474,955,502,453,475,455,20,185,185,0,156,156,0,112,111,1,8,8,0
,,White,261,81,180,246,77,169,75,65,10,24,24,0,21,21,0,18,17,1,1,1,0
,,Black,689,445,244,630,394,236,369,361,8,146,146,0,122,122,0,85,85,0,6,6,0
,,Hispanic,56,30,26,53,28,25,26,25,1,12,12,0,11,11,0,7,7,0,0,0,0
,,Asian,20,3,17,18,2,16,4,3,1,3,3,0,2,2,0,2,2,0,1,1,0
,,,,,,,,,,,,,,,,,,,,,,,
,,,,,,,,,,,,,,,,,,,,,,,
,,American Indian/Alaska Native,1,0,1,1,0,1,0,0,0,0,0,0,0,0,0,0,0,0,0,0,0
,,Pacific Islander,3,0,3,3,0,3,0,0,0,0,0,0,0,0,0,0,0,0,0,0,0
,,Multiracial,4,1,3,4,1,3,1,1,0,0,0,0,0,0,0,0,0,0,0,0,0
,Florida,All Ethnicities,20774,14567,6207,19064,13009,6055,11974,11843,131,4588,4587,1,2682,2680,2,2408,2389,19,388,388,0
,,White,14346,10085,4261,13207,9066,4141,8138,8038,100,3048,3047,1,1707,1706,1,1539,1520,19,194,194,0
,,Black,2853,2065,788,2528,1749,779,1826,1818,8,709,709,0,458,457,1,435,435,0,84,84,0
,,Hispanic,3138,2135,1003,2930,1946,984,1770,1751,19,751,751,0,472,472,0,379,379,0,102,102,0
,,Unknown,24,20,4,20,16,4,17,17,0,5,5,0,3,3,0,2,2,0,1,1,0
,,Asian,275,168,107,250,146,104,143,140,3,45,45,0,20,20,0,39,39,0,4,4,0
,,American Indian/Alaska Native,26,17,9,26,17,9,16,16,0,8,8,0,6,6,0,2,2,0,0,0,0
,,Pacific Islander,23,14,9,20,11,9,11,11,0,2,2,0,1,1,0,1,1,0,0,0,0
,,Multiracial,89,63,26,83,58,25,53,52,1,20,20,0,15,15,0,11,11,0,3,3,0
,Georgia,All Ethnicities,10557,6486,4071,9581,5610,3971,5562,5469,93,2367,2366,1,981,979,2,1172,1168,4,117,117,0
,,White,6890,4132,2758,6355,3678,2677,3497,3423,74,1528,1527,1,652,650,2,684,680,4,69,69,0
,,Black,2972,1939,1033,2584,1563,1021,1706,1694,12,652,652,0,251,251,0,394,394,0,35,35,0
,,Hispanic,482,309,173,442,275,167,269,263,6,152,152,0,64,64,0,69,69,0,7,7,0
,,Unknown,3,2,1,3,2,1,2,2,0,0,0,0,0,0,0,0,0,0,0,0,0
,,Asian,159,82,77,149,73,76,69,68,1,22,22,0,11,11,0,22,22,0,2,2,0
,,American Indian/Alaska Native,6,1,5,6,1,5,1,1,0,0,0,0,0,0,0,0,0,0,0,0,0
,,Pacific Islander,10,3,7,9,2,7,3,3,0,2,2,0,0,0,0,2,2,0,0,0,0
,,Multiracial,35,18,17,33,16,17,15,15,0,11,11,0,3,3,0,1,1,0,4,4,0
,Hawaii,All Ethnicities,1303,791,512,1256,762,494,594,576,18,69,69,0,109,109,0,32,32,0,1,1,0
,,White,443,260,183,429,255,174,174,165,9,29,29,0,39,39,0,13,13,0,0,0,0
,,Black,18,8,10,17,7,10,5,5,0,0,0,0,1,1,0,1,1,0,0,0,0
,,Hispanic,32,16,16,31,16,15,13,12,1,1,1,0,3,3,0,1,1,0,0,0,0
,,Unknown,5,3,2,5,3,2,3,3,0,0,0,0,0,0,0,0,0,0,0,0,0
,,Asian,430,264,166,413,250,163,210,207,3,15,15,0,27,27,0,10,10,0,1,1,0
,,American Indian/Alaska Native,4,2,2,4,2,2,0,0,0,1,1,0,0,0,0,0,0,0,0,0,0
,,Pacific Islander,273,194,79,261,187,74,151,146,5,21,21,0,32,32,0,7,7,0,0,0,0
,,Multiracial,98,44,54,96,42,54,38,38,0,2,2,0,7,7,0,0,0,0,0,0,0
,Idaho,All Ethnicities,1676,930,746,1601,883,718,779,753,26,374,372,2,201,201,0,148,148,0,15,15,0
,,White,1525,844,681,1459,803,656,708,685,23,337,335,2,183,183,0,131,131,0,11,11,0
,,Black,19,11,8,19,11,8,10,10,0,4,4,0,5,5,0,1,1,0,1,1,0
,,Hispanic,99,61,38,91,55,36,48,46,2,25,25,0,10,10,0,13,13,0,2,2,0
,,Asian,4,2,2,4,2,2,2,2,0,0,0,0,0,0,0,1,1,0,0,0,0
,,American Indian/Alaska Native,18,8,10,17,8,9,7,6,1,6,6,0,2,2,0,1,1,0,1,1,0
,,Pacific Islander,4,1,3,4,1,3,1,1,0,1,1,0,0,0,0,0,0,0,0,0,0
,,Multiracial,7,3,4,7,3,4,3,3,0,1,1,0,1,1,0,1,1,0,0,0,0
,Illinois,All Ethnicities,17991,9630,8361,16603,8705,7898,7906,7468,438,3052,3052,0,2659,2651,8,1852,1846,6,159,139,20
,,White,11533,6305,5228,10707,5823,4884,5061,4730,331,1911,1911,0,1707,1702,5,1098,1095,3,89,80,9
,,Black,3569,2187,1382,3201,1854,1347,1893,1862,31,717,717,0,617,617,0,488,488,0,47,42,5
,,,,,,,,,,,,,,,,,,,,,,,
,,,,,,,,,,,,,,,,,,,,,,,
,,Hispanic,2390,935,1455,2236,855,1381,787,721,66,376,376,0,297,295,2,221,218,3,21,15,6
,,Unknown,3,2,1,2,1,1,2,2,0,0,0,0,1,1,0,0,0,0,0,0,0
,,Asian,383,167,216,353,144,209,136,129,7,37,37,0,30,29,1,41,41,0,1,1,0
,,American Indian/Alaska Native,13,9,4,11,7,4,6,6,0,2,2,0,2,2,0,2,2,0,0,0,0
,,Pacific Islander,30,11,19,28,10,18,9,8,1,1,1,0,3,3,0,0,0,0,0,0,0
,,Multiracial,70,14,56,65,11,54,12,10,2,8,8,0,2,2,0,2,2,0,1,1,0
,Indiana,All Ethnicities,7895,4736,3159,7467,4386,3081,4128,4062,66,1950,1950,0,1218,1217,1,1010,1002,8,204,201,3
,,White,6696,3966,2730,6368,3708,2660,3447,3387,60,1623,1623,0,995,994,1,823,817,6,164,161,3
,,Black,830,580,250,745,499,246,515,513,2,247,247,0,166,166,0,147,145,2,31,31,0
,,Hispanic,282,145,137,273,138,135,125,123,2,67,67,0,45,45,0,33,33,0,8,8,0
,,Unknown,1,1,0,1,1,0,1,1,0,0,0,0,0,0,0,0,0,0,0,0,0
,,Asian,63,34,29,59,31,28,31,30,1,8,8,0,11,11,0,7,7,0,1,1,0
,,American Indian/Alaska Native,4,3,1,4,3,1,2,2,0,1,1,0,0,0,0,0,0,0,0,0,0
,,Pacific Islander,6,3,3,5,3,2,4,3,1,1,1,0,1,1,0,0,0,0,0,0,0
,,Multiracial,13,4,9,12,3,9,3,3,0,3,3,0,0,0,0,0,0,0,0,0,0
,Iowa,All Ethnicities,3825,1949,1876,3666,1847,1819,1674,1623,51,719,719,0,561,559,2,353,348,5,39,38,1
,,White,3582,1811,1771,3440,1724,1716,1557,1508,49,662,662,0,529,527,2,318,313,5,30,29,1
,,Black,116,69,47,107,60,47,58,58,0,32,32,0,16,16,0,17,17,0,5,5,0
,,Hispanic,90,46,44,83,41,42,40,38,2,19,19,0,11,11,0,11,11,0,3,3,0
,,Asian,28,20,8,28,20,8,18,18,0,5,5,0,4,4,0,6,6,0,1,1,0
,,American Indian/Alaska Native,7,3,4,6,2,4,1,1,0,1,1,0,1,1,0,1,1,0,0,0,0
,,Multiracial,2,0,2,2,0,2,0,0,0,0,0,0,0,0,0,0,0,0,0,0,0
,Kansas,All Ethnicities,3656,2568,1088,3431,2378,1053,2141,2111,30,937,937,0,659,658,1,501,496,5,51,51,0
,,White,3086,2138,948,2901,1985,916,1767,1740,27,763,763,0,546,545,1,390,385,5,42,42,0
,,Black,233,174,59,213,155,58,159,158,1,65,65,0,39,39,0,45,45,0,3,3,0
,,Hispanic,272,214,58,255,198,57,176,175,1,91,91,0,62,62,0,54,54,0,3,3,0
,,Unknown,1,1,0,1,1,0,1,1,0,0,0,0,0,0,0,0,0,0,0,0,0
,,Asian,35,26,9,34,25,9,24,24,0,10,10,0,5,5,0,5,5,0,1,1,0
,,American Indian/Alaska Native,16,12,4,15,11,4,10,10,0,6,6,0,4,4,0,6,6,0,1,1,0
,,Pacific Islander,4,1,3,4,1,3,1,1,0,1,1,0,1,1,0,0,0,0,0,0,0
,,Multiracial,9,2,7,8,2,6,3,2,1,1,1,0,2,2,0,1,1,0,1,1,0
,Kentucky,All Ethnicities,4756,2927,1829,4521,2734,1787,2486,2446,40,1091,1091,0,701,699,2,542,541,1,47,47,0
,,White,4275,2606,1669,4069,2440,1629,2200,2162,38,968,968,0,613,611,2,467,466,1,40,40,0
,,Black,373,256,117,350,234,116,226,225,1,91,91,0,66,66,0,62,62,0,6,6,0
,,Hispanic,67,43,24,62,39,23,41,40,1,23,23,0,15,15,0,7,7,0,0,0,0
,,Asian,24,11,13,24,11,13,10,10,0,4,4,0,3,3,0,3,3,0,0,0,0
,,American Indian/Alaska Native,3,3,0,2,2,0,2,2,0,1,1,0,1,1,0,0,0,0,0,0,0
,,Pacific Islander,4,2,2,4,2,2,1,1,0,1,1,0,0,0,0,0,0,0,0,0,0
,,Multiracial,10,6,4,10,6,4,6,6,0,3,3,0,3,3,0,3,3,0,1,1,0
,Louisiana,All Ethnicities,5950,4044,1906,5436,3573,1863,3652,3613,39,1498,1498,0,984,984,0,822,820,2,77,75,2
,,White,3898,2635,1263,3650,2414,1236,2379,2356,23,1026,1026,0,698,698,0,532,530,2,48,46,2
,,,,,,,,,,,,,,,,,,,,,,,
,,,,,,,,,,,,,,,,,,,,,,,
,,Black,1842,1281,561,1600,1050,550,1162,1151,11,415,415,0,262,262,0,269,269,0,28,28,0
,,Hispanic,128,87,41,108,70,38,75,72,3,42,42,0,13,13,0,17,17,0,1,1,0
,,Unknown,1,1,0,1,1,0,1,1,0,1,1,0,0,0,0,0,0,0,0,0,0
,,Asian,63,33,30,60,31,29,30,29,1,12,12,0,9,9,0,4,4,0,0,0,0
,,American Indian/Alaska Native,10,5,5,9,5,4,3,2,1,2,2,0,2,2,0,0,0,0,0,0,0
,,Pacific Islander,1,0,1,1,0,1,0,0,0,0,0,0,0,0,0,0,0,0,0,0,0
,,Multiracial,7,2,5,7,2,5,2,2,0,0,0,0,0,0,0,0,0,0,0,0,0
,Maine,All Ethnicities,1770,934,836,1649,888,761,783,718,65,336,336,0,208,207,1,136,126,10,17,17,0
,,White,1704,904,800,1590,861,729,752,691,61,322,322,0,199,198,1,132,122,10,15,15,0
,,Black,30,12,18,25,9,16,13,11,2,4,4,0,4,4,0,1,1,0,0,0,0
,,Hispanic,21,11,10,20,11,9,10,9,1,7,7,0,4,4,0,2,2,0,2,2,0
,,Asian,9,4,5,8,4,4,5,4,1,1,1,0,1,1,0,1,1,0,0,0,0
,,American Indian/Alaska Native,1,0,1,1,0,1,0,0,0,0,0,0,0,0,0,0,0,0,0,0,0
,,Multiracial,5,3,2,5,3,2,3,3,0,2,2,0,0,0,0,0,0,0,0,0,0
,Maryland,All Ethnicities,8941,4570,4371,8304,4184,4120,4035,3787,248,1436,1436,0,1162,1161,1,1007,1004,3,54,54,0
,,White,5389,2832,2557,5022,2651,2371,2481,2298,183,851,851,0,698,698,0,559,556,3,31,31,0
,,Black,2891,1428,1463,2649,1234,1415,1276,1228,48,482,482,0,376,375,1,355,355,0,15,15,0
,,Hispanic,346,180,166,334,177,157,163,154,9,73,73,0,61,61,0,57,57,0,7,7,0
,,Unknown,3,0,3,3,0,3,0,0,0,0,0,0,0,0,0,0,0,0,0,0,0
,,Asian,230,109,121,215,102,113,98,90,8,26,26,0,20,20,0,33,33,0,1,1,0
,,American Indian/Alaska Native,14,4,10,14,4,10,2,2,0,0,0,0,0,0,0,0,0,0,0,0,0
,,Pacific Islander,27,5,22,27,5,22,5,5,0,1,1,0,3,3,0,1,1,0,0,0,0
,,Multiracial,41,12,29,40,11,29,10,10,0,3,3,0,4,4,0,2,2,0,0,0,0
,Massachusetts,All Ethnicities,7947,3717,4230,7368,3476,3892,3063,2761,302,1242,1242,0,615,614,1,536,502,34,34,33,1
,,White,6599,3061,3538,6108,2874,3234,2503,2235,268,977,977,0,477,476,1,421,387,34,23,22,1
,,Black,468,215,253,439,193,246,176,169,7,83,83,0,39,39,0,40,40,0,3,3,0
,,Hispanic,664,361,303,619,335,284,306,287,19,157,157,0,84,84,0,62,62,0,6,6,0
,,Unknown,4,4,0,4,4,0,2,2,0,2,2,0,1,1,0,0,0,0,0,0,0
,,Asian,166,55,111,154,50,104,56,49,7,13,13,0,11,11,0,13,13,0,1,1,0
,,American Indian/Alaska Native,7,5,2,7,5,2,4,4,0,3,3,0,1,1,0,0,0,0,0,0,0
,,Pacific Islander,4,0,4,4,0,4,0,0,0,0,0,0,0,0,0,0,0,0,0,0,0
,,Multiracial,35,16,19,33,15,18,16,15,1,7,7,0,2,2,0,0,0,0,1,1,0
,Michigan,All Ethnicities,14393,7804,6589,13598,7232,6366,6036,5822,214,2549,2548,1,1425,1425,0,1555,1548,7,154,153,1
,,White,11671,6299,5372,11101,5926,5175,4794,4605,189,2010,2009,1,1146,1146,0,1190,1183,7,108,108,0
,,Black,2081,1210,871,1893,1038,855,1001,986,15,431,431,0,237,237,0,292,292,0,41,40,1
,,Hispanic,406,199,207,373,175,198,173,164,9,80,80,0,29,29,0,47,47,0,3,3,0
,,Unknown,3,0,3,3,0,3,0,0,0,0,0,0,0,0,0,0,0,0,0,0,0
,,Asian,151,65,86,147,62,85,50,49,1,20,20,0,9,9,0,22,22,0,2,2,0
,,American Indian/Alaska Native,33,16,17,33,16,17,9,9,0,2,2,0,1,1,0,1,1,0,0,0,0
,,Pacific Islander,17,7,10,17,7,10,5,5,0,3,3,0,2,2,0,1,1,0,0,0,0
,,Multiracial,31,8,23,31,8,23,4,4,0,3,3,0,1,1,0,2,2,0,0,0,0
,,,,,,,,,,,,,,,,,,,,,,,
,,,,,,,,,,,,,,,,,,,,,,,
,Minnesota,All Ethnicities,8474,3396,5078,8017,3185,4832,3091,2866,225,1307,1304,3,1403,1383,20,697,686,11,90,86,4
,,White,7633,3082,4551,7227,2903,4324,2800,2592,208,1173,1170,3,1280,1262,18,620,610,10,81,78,3
,,Black,338,137,201,317,122,195,128,123,5,58,58,0,60,59,1,35,35,0,2,1,1
,,Hispanic,205,87,118,191,81,110,84,76,8,40,40,0,31,31,0,17,17,0,2,2,0
,,Unknown,6,1,5,5,1,4,1,1,0,1,1,0,1,1,0,1,0,1,0,0,0
,,Asian,148,41,107,141,35,106,34,33,1,15,15,0,13,12,1,15,15,0,2,2,0
,,American Indian/Alaska Native,115,39,76,110,36,74,35,33,2,15,15,0,13,13,0,6,6,0,1,1,0
,,Pacific Islander,6,2,4,6,2,4,2,2,0,1,1,0,2,2,0,1,1,0,0,0,0
,,Multiracial,23,7,16,20,5,15,7,6,1,4,4,0,3,3,0,2,2,0,2,2,0
,Mississippi,All Ethnicities,3136,2122,1014,2933,1955,978,1726,1694,32,721,720,1,395,395,0,316,313,3,63,63,0
,,White,2184,1439,745,2061,1349,712,1159,1129,30,488,487,1,272,272,0,179,177,2,41,41,0
,,Black,884,635,249,811,563,248,530,529,1,214,214,0,117,117,0,130,130,0,20,20,0
,,Hispanic,37,29,8,32,25,7,22,22,0,12,12,0,3,3,0,4,3,1,0,0,0
,,Asian,20,11,9,19,10,9,9,9,0,5,5,0,1,1,0,3,3,0,1,1,0
,,American Indian/Alaska Native,6,5,1,6,5,1,3,3,0,2,2,0,1,1,0,0,0,0,1,1,0
,,Pacific Islander,1,1,0,1,1,0,0,0,0,0,0,0,0,0,0,0,0,0,0,0,0
,,Multiracial,4,2,2,3,2,1,3,2,1,0,0,0,1,1,0,0,0,0,0,0,0
,Missouri,All Ethnicities,7950,5445,2505,7236,4797,2439,4631,4569,62,1863,1863,0,1127,1127,0,1218,1214,4,102,102,0
,,White,6543,4389,2154,6036,3942,2094,3713,3657,56,1498,1498,0,931,931,0,937,933,4,73,73,0
,,Black,1131,874,257,957,703,254,763,760,3,301,301,0,159,159,0,233,233,0,23,23,0
,,Hispanic,162,114,48,141,95,46,95,93,2,42,42,0,25,25,0,29,29,0,3,3,0
,,Asian,68,38,30,61,32,29,34,33,1,10,10,0,7,7,0,13,13,0,3,3,0
,,American Indian/Alaska Native,20,15,5,16,11,5,13,13,0,5,5,0,3,3,0,3,3,0,0,0,0
,,Pacific Islander,9,7,2,9,7,2,6,6,0,4,4,0,2,2,0,3,3,0,0,0,0
,,Multiracial,17,8,9,16,7,9,7,7,0,3,3,0,0,0,0,0,0,0,0,0,0
,Montana,All Ethnicities,1236,676,560,1178,643,535,577,554,23,295,294,1,171,171,0,104,103,1,11,11,0
,,White,1131,621,510,1077,592,485,534,511,23,276,275,1,158,158,0,95,94,1,10,10,0
,,Black,6,4,2,5,3,2,4,4,0,1,1,0,2,2,0,1,1,0,0,0,0
,,Hispanic,22,16,6,21,15,6,13,13,0,5,5,0,3,3,0,4,4,0,0,0,0
,,Asian,4,4,0,4,4,0,4,4,0,2,2,0,1,1,0,0,0,0,0,0,0
,,American Indian/Alaska Native,70,29,41,68,27,41,20,20,0,11,11,0,6,6,0,4,4,0,1,1,0
,,Multiracial,3,2,1,3,2,1,2,2,0,0,0,0,1,1,0,0,0,0,0,0,0
,Nebraska,All Ethnicities,2312,1283,1029,2183,1200,983,1139,1099,40,443,443,0,422,422,0,231,225,6,35,35,0
,,White,2034,1105,929,1919,1036,883,986,946,40,375,375,0,381,381,0,196,190,6,29,29,0
,,Black,120,82,38,112,74,38,72,72,0,29,29,0,24,24,0,17,17,0,0,0,0
,,Hispanic,117,67,50,112,62,50,59,59,0,31,31,0,10,10,0,12,12,0,6,6,0
,,Asian,20,16,4,19,15,4,12,12,0,1,1,0,4,4,0,5,5,0,0,0,0
,,American Indian/Alaska Native,15,10,5,15,10,5,7,7,0,5,5,0,2,2,0,0,0,0,0,0,0
,,Multiracial,6,3,3,6,3,3,3,3,0,2,2,0,1,1,0,1,1,0,0,0,0
,Nevada,All Ethnicities,2972,1992,980,2769,1836,933,1687,1648,39,706,706,0,310,310,0,344,336,8,21,21,0
,,White,2046,1354,692,1929,1267,662,1148,1123,25,474,474,0,212,212,0,197,192,5,13,13,0
,,,,,,,,,,,,,,,,,,,,,,,
,,,,,,,,,,,,,,,,,,,,,,,
,,Black,259,177,82,234,152,82,151,151,0,56,56,0,25,25,0,34,34,0,1,1,0
,,Hispanic,449,323,126,413,298,115,266,256,10,140,140,0,53,53,0,70,69,1,7,7,0
,,Asian,146,98,48,128,83,45,84,83,1,23,23,0,12,12,0,35,33,2,0,0,0
,,American Indian/Alaska Native,18,8,10,17,8,9,5,4,1,4,4,0,1,1,0,0,0,0,0,0,0
,,Pacific Islander,26,18,8,24,16,8,18,18,0,4,4,0,3,3,0,3,3,0,0,0,0
,,Multiracial,28,14,14,24,12,12,15,13,2,5,5,0,4,4,0,5,5,0,0,0,0
,New Hampshire,All Ethnicities,1687,793,894,1575,745,830,664,605,59,270,270,0,157,157,0,140,135,5,3,3,0
,,White,1609,750,859,1504,708,796,628,570,58,251,251,0,148,148,0,128,123,5,3,3,0
,,Black,23,16,7,19,12,7,14,14,0,8,8,0,5,5,0,4,4,0,0,0,0
,,Hispanic,36,17,19,35,16,19,15,15,0,6,6,0,3,3,0,5,5,0,0,0,0
,,Asian,16,8,8,14,7,7,5,4,1,3,3,0,0,0,0,2,2,0,0,0,0
,,Multiracial,3,2,1,3,2,1,2,2,0,2,2,0,1,1,0,1,1,0,0,0,0
,New Jersey,All Ethnicities,11172,5640,5532,10535,5231,5304,4616,4392,224,1803,1803,0,1096,1096,0,784,780,4,43,43,0
,,White,7193,3605,3588,6790,3387,3403,2910,2728,182,1083,1083,0,669,669,0,445,442,3,20,20,0
,,Black,1701,919,782,1586,809,777,772,767,5,302,302,0,187,187,0,139,139,0,15,15,0
,,Hispanic,1708,874,834,1618,814,804,728,699,29,359,359,0,201,201,0,155,154,1,6,6,0
,,Unknown,3,2,1,3,2,1,2,2,0,2,2,0,2,2,0,1,1,0,0,0,0
,,Asian,483,202,281,456,183,273,170,162,8,42,42,0,29,29,0,31,31,0,1,1,0
,,American Indian/Alaska Native,7,1,6,7,1,6,1,1,0,0,0,0,0,0,0,1,1,0,0,0,0
,,Pacific Islander,27,13,14,25,11,14,11,11,0,2,2,0,3,3,0,5,5,0,1,1,0
,,Multiracial,50,24,26,50,24,26,22,22,0,13,13,0,5,5,0,7,7,0,0,0,0
,New Mexico,All Ethnicities,2328,1459,869,2199,1363,836,1184,1152,32,543,543,0,201,201,0,194,194,0,19,18,1
,,White,1170,735,435,1100,683,417,601,584,17,252,252,0,101,101,0,96,96,0,8,7,1
,,Black,53,40,13,50,37,13,37,37,0,14,14,0,6,6,0,5,5,0,0,0,0
,,Hispanic,991,632,359,943,594,349,502,492,10,257,257,0,89,89,0,87,87,0,10,10,0
,,Asian,19,12,7,17,11,6,13,12,1,3,3,0,0,0,0,1,1,0,0,0,0
,,American Indian/Alaska Native,79,35,44,74,33,41,26,23,3,15,15,0,5,5,0,5,5,0,0,0,0
,,Pacific Islander,1,0,1,1,0,1,0,0,0,0,0,0,0,0,0,0,0,0,0,0,0
,,Multiracial,15,5,10,14,5,9,5,4,1,2,2,0,0,0,0,0,0,0,1,1,0
,New York,All Ethnicities,22604,11042,11562,20099,9458,10641,9863,8959,904,3344,3344,0,1763,1761,2,1127,1111,16,140,140,0
,,White,13911,6670,7241,12481,5879,6602,5931,5308,623,1912,1912,0,1076,1074,2,664,649,15,75,75,0
,,Black,3547,1869,1678,3077,1466,1611,1668,1601,67,589,589,0,300,300,0,200,200,0,31,31,0
,,Hispanic,4067,2032,2035,3594,1707,1887,1815,1668,147,714,714,0,309,309,0,217,216,1,25,25,0
,,Unknown,6,4,2,6,4,2,2,2,0,1,1,0,1,1,0,0,0,0,0,0,0
,,Asian,739,292,447,655,255,400,286,239,47,60,60,0,47,47,0,29,29,0,4,4,0
,,American Indian/Alaska Native,34,16,18,31,15,16,9,7,2,8,8,0,2,2,0,2,2,0,0,0,0
,,Pacific Islander,44,10,34,41,9,32,11,9,2,0,0,0,1,1,0,2,2,0,0,0,0
,,Multiracial,256,149,107,214,123,91,141,125,16,60,60,0,27,27,0,13,13,0,5,5,0
,North Carolina,All Ethnicities,10187,6264,3923,9526,5749,3777,5121,4985,136,2438,2437,1,1520,1520,0,1328,1319,9,127,127,0
,,White,7362,4516,2846,6924,4200,2724,3638,3526,112,1727,1726,1,1092,1092,0,866,857,9,66,66,0
,,Black,2237,1376,861,2044,1198,846,1163,1148,15,536,536,0,328,328,0,353,353,0,45,45,0
,,,,,,,,,,,,,,,,,,,,,,,
,,,,,,,,,,,,,,,,,,,,,,,
,,Hispanic,360,255,105,341,239,102,214,211,3,132,132,0,72,72,0,77,77,0,13,13,0
,,Unknown,2,2,0,2,2,0,2,2,0,1,1,0,1,1,0,0,0,0,0,0,0
,,Asian,84,51,33,80,50,30,44,41,3,16,16,0,11,11,0,13,13,0,1,1,0
,,American Indian/Alaska Native,98,51,47,93,48,45,47,45,2,20,20,0,15,15,0,13,13,0,2,2,0
,,Pacific Islander,4,1,3,4,1,3,1,1,0,1,1,0,0,0,0,1,1,0,0,0,0
,,Multiracial,40,12,28,38,11,27,12,11,1,5,5,0,1,1,0,5,5,0,0,0,0
,North Dakota,All Ethnicities,1029,464,565,985,440,545,399,380,19,171,171,0,182,181,1,76,76,0,14,13,1
,,White,916,431,485,872,407,465,372,353,19,155,155,0,169,168,1,66,66,0,12,11,1
,,Black,12,7,5,12,7,5,7,7,0,3,3,0,1,1,0,3,3,0,1,1,0
,,Hispanic,16,7,9,16,7,9,5,5,0,3,3,0,2,2,0,2,2,0,0,0,0
,,Asian,5,2,3,5,2,3,1,1,0,0,0,0,0,0,0,0,0,0,0,0,0
,,American Indian/Alaska Native,75,16,59,75,16,59,13,13,0,9,9,0,9,9,0,5,5,0,1,1,0
,,Pacific Islander,1,0,1,1,0,1,0,0,0,0,0,0,0,0,0,0,0,0,0,0,0
,,Multiracial,4,1,3,4,1,3,1,1,0,1,1,0,1,1,0,0,0,0,0,0,0
,Ohio,All Ethnicities,15946,8889,7057,15033,8211,6822,7422,7199,223,3000,2999,1,2377,2374,3,1675,1666,9,137,137,0
,,White,13467,7455,6012,12746,6956,5790,6173,5963,210,2469,2468,1,1962,1959,3,1324,1315,9,110,110,0
,,Black,2067,1230,837,1897,1068,829,1077,1069,8,445,445,0,351,351,0,305,305,0,20,20,0
,,Hispanic,236,123,113,224,115,109,108,104,4,62,62,0,40,40,0,29,29,0,4,4,0
,,Unknown,3,2,1,3,2,1,1,1,0,1,1,0,0,0,0,0,0,0,0,0,0
,,Asian,112,61,51,106,55,51,48,48,0,17,17,0,18,18,0,12,12,0,2,2,0
,,American Indian/Alaska Native,5,2,3,4,1,3,2,2,0,0,0,0,0,0,0,0,0,0,0,0,0
,,Pacific Islander,5,1,4,5,1,4,0,0,0,0,0,0,0,0,0,0,0,0,0,0,0
,,Multiracial,51,15,36,48,13,35,13,12,1,6,6,0,6,6,0,5,5,0,1,1,0
,Oklahoma,All Ethnicities,4334,3061,1273,4076,2836,1240,2430,2400,30,1094,1094,0,392,392,0,454,451,3,31,31,0
,,White,3568,2523,1045,3363,2346,1017,1992,1967,25,899,899,0,312,312,0,355,352,3,25,25,0
,,Black,341,254,87,315,229,86,207,206,1,91,91,0,34,34,0,50,50,0,4,4,0
,,Hispanic,191,135,56,178,125,53,110,107,3,51,51,0,28,28,0,30,30,0,1,1,0
,,Asian,35,27,8,34,26,8,20,20,0,8,8,0,1,1,0,1,1,0,1,1,0
,,American Indian/Alaska Native,179,113,66,167,102,65,93,92,1,39,39,0,14,14,0,17,17,0,0,0,0
,,Pacific Islander,7,3,4,7,3,4,3,3,0,2,2,0,1,1,0,1,1,0,0,0,0
,,Multiracial,13,6,7,12,5,7,5,5,0,4,4,0,2,2,0,0,0,0,0,0,0
,Oregon,All Ethnicities,3813,2031,1782,3681,1953,1728,1709,1667,42,765,761,4,414,414,0,272,264,8,10,10,0
,,White,3405,1816,1589,3289,1750,1539,1531,1493,38,664,660,4,369,369,0,230,222,8,9,9,0
,,Black,57,36,21,54,33,21,30,30,0,18,18,0,6,6,0,4,4,0,0,0,0
,,Hispanic,214,117,97,207,113,94,95,92,3,62,62,0,30,30,0,23,23,0,1,1,0
,,Asian,81,39,42,80,38,42,32,32,0,13,13,0,7,7,0,9,9,0,0,0,0
,,American Indian/Alaska Native,15,6,9,14,5,9,4,4,0,1,1,0,0,0,0,0,0,0,0,0,0
,,Pacific Islander,22,10,12,20,8,12,9,9,0,4,4,0,1,1,0,4,4,0,0,0,0
,,Multiracial,19,7,12,17,6,11,8,7,1,3,3,0,1,1,0,2,2,0,0,0,0
,Pennsylvania,All Ethnicities,19932,12791,7141,18342,11770,6572,11001,10447,554,4008,4008,0,2693,2689,4,2271,2259,12,178,177,1
,,White,16359,10323,6036,15104,9601,5503,8905,8384,521,3172,3172,0,2184,2180,4,1742,1733,9,145,144,1
,,,,,,,,,,,,,,,,,,,,,,,
,,,,,,,,,,,,,,,,,,,,,,,
,,Black,2377,1687,690,2144,1468,676,1433,1419,14,546,546,0,356,356,0,346,346,0,22,22,0
,,Hispanic,888,617,271,805,549,256,523,511,12,235,235,0,129,129,0,140,137,3,10,10,0
,,Unknown,1,1,0,1,1,0,1,1,0,0,0,0,0,0,0,0,0,0,0,0,0
,,Asian,229,121,108,212,110,102,104,98,6,35,35,0,18,18,0,31,31,0,1,1,0
,,American Indian/Alaska Native,10,7,3,9,6,3,5,5,0,5,5,0,1,1,0,2,2,0,0,0,0
,,Pacific Islander,13,2,11,13,2,11,2,2,0,0,0,0,0,0,0,0,0,0,0,0,0
,,Multiracial,55,33,22,54,33,21,28,27,1,15,15,0,5,5,0,10,10,0,0,0,0
,Puerto Rico,All Ethnicities,2737,1879,858,2451,1635,816,1567,1526,41,355,355,0,245,244,1,246,245,1,29,29,0
,,White,61,18,43,56,14,42,11,11,0,3,3,0,0,0,0,1,0,1,1,1,0
,,Black,7,2,5,7,2,5,1,1,0,1,1,0,1,1,0,1,1,0,0,0,0
,,Hispanic,1983,1195,788,1801,1054,747,972,931,41,237,237,0,137,136,1,106,106,0,21,21,0
,,Unknown,1,0,1,1,0,1,0,0,0,0,0,0,0,0,0,0,0,0,0,0,0
,,Asian,1,0,1,1,0,1,0,0,0,0,0,0,0,0,0,0,0,0,0,0,0
,,Multiracial,684,664,20,585,565,20,583,583,0,114,114,0,107,107,0,138,138,0,7,7,0
,Rhode Island,All Ethnicities,1229,502,727,1154,468,686,393,356,37,178,178,0,102,102,0,62,58,4,4,4,0
,,White,1033,419,614,970,392,578,328,296,32,148,148,0,86,86,0,56,52,4,2,2,0
,,Black,63,26,37,61,25,36,16,15,1,7,7,0,1,1,0,1,1,0,0,0,0
,,Hispanic,105,46,59,96,41,55,42,38,4,19,19,0,12,12,0,4,4,0,2,2,0
,,Asian,17,7,10,17,7,10,4,4,0,2,2,0,2,2,0,1,1,0,0,0,0
,,American Indian/Alaska Native,5,0,5,5,0,5,0,0,0,0,0,0,0,0,0,0,0,0,0,0,0
,,Pacific Islander,3,2,1,2,1,1,2,2,0,1,1,0,1,1,0,0,0,0,0,0,0
,,Multiracial,3,2,1,3,2,1,1,1,0,1,1,0,0,0,0,0,0,0,0,0,0
,South Carolina,All Ethnicities,5383,3659,1724,5086,3404,1682,3210,3172,38,1413,1413,0,760,760,0,736,732,4,51,51,0
,,White,3876,2571,1305,3711,2438,1273,2231,2203,28,1023,1023,0,555,555,0,463,459,4,31,31,0
,,Black,1301,949,352,1180,835,345,853,846,7,325,325,0,174,174,0,239,239,0,19,19,0
,,Hispanic,134,104,30,127,99,28,94,92,2,53,53,0,24,24,0,26,26,0,0,0,0
,,Unknown,3,1,2,3,1,2,0,0,0,0,0,0,1,1,0,0,0,0,0,0,0
,,Asian,43,23,20,40,21,19,21,20,1,6,6,0,4,4,0,5,5,0,0,0,0
,,American Indian/Alaska Native,5,2,3,5,2,3,2,2,0,2,2,0,1,1,0,1,1,0,1,1,0
,,Pacific Islander,6,1,5,6,1,5,1,1,0,1,1,0,1,1,0,0,0,0,0,0,0
,,Multiracial,15,8,7,14,7,7,8,8,0,3,3,0,0,0,0,2,2,0,0,0,0
,South Dakota,All Ethnicities,1111,557,554,1066,530,536,505,487,18,202,202,0,233,232,1,124,124,0,16,16,0
,,White,981,484,497,945,464,481,438,422,16,172,172,0,203,202,1,104,104,0,15,15,0
,,Black,13,12,1,10,9,1,11,11,0,7,7,0,3,3,0,7,7,0,1,1,0
,,Hispanic,20,7,13,19,6,13,7,7,0,2,2,0,5,5,0,4,4,0,0,0,0
,,Asian,5,3,2,5,3,2,2,2,0,0,0,0,0,0,0,0,0,0,0,0,0
,,American Indian/Alaska Native,81,47,34,76,44,32,43,41,2,21,21,0,20,20,0,9,9,0,0,0,0
,,Pacific Islander,2,2,0,2,2,0,2,2,0,0,0,0,2,2,0,0,0,0,0,0,0
,,Multiracial,9,2,7,9,2,7,2,2,0,0,0,0,0,0,0,0,0,0,0,0,0
,State unassigned,All Ethnicities,7828,3170,4658,7280,2945,4335,2596,2310,286,1279,1273,6,640,636,4,477,449,28,26,25,1
,,White,3415,1600,1815,3125,1508,1617,1273,1105,168,625,619,6,285,283,2,205,183,22,5,5,0
,,,,,,,,,,,,,,,,,,,,,,,
,,,,,,,,,,,,,,,,,,,,,,,
,,Black,745,343,402,692,306,386,285,269,16,132,132,0,66,65,1,56,56,0,6,6,0
,,Hispanic,2457,925,1532,2299,849,1450,779,700,79,428,428,0,229,229,0,170,168,2,10,9,1
,,Unknown,195,121,74,187,115,72,99,97,2,48,48,0,34,33,1,14,14,0,3,3,0
,,Asian,831,148,683,804,139,665,129,114,15,36,36,0,21,21,0,28,25,3,2,2,0
,,American Indian/Alaska Native,16,5,11,15,5,10,4,3,1,2,2,0,1,1,0,1,1,0,0,0,0
,,Pacific Islander,107,9,98,99,4,95,10,8,2,1,1,0,0,0,0,3,2,1,0,0,0
,,Multiracial,62,19,43,59,19,40,17,14,3,7,7,0,4,4,0,0,0,0,0,0,0
,Tennessee,All Ethnicities,8081,5244,2837,7535,4765,2770,4480,4417,63,2090,2090,0,1156,1155,1,974,970,4,129,129,0
,,White,6494,4232,2262,6094,3885,2209,3583,3533,50,1674,1674,0,901,900,1,738,735,3,91,91,0
,,Black,1285,814,471,1162,701,461,714,705,9,306,306,0,195,195,0,181,180,1,27,27,0
,,Hispanic,216,148,68,198,133,65,139,136,3,89,89,0,47,47,0,44,44,0,7,7,0
,,Unknown,2,1,1,2,1,1,1,1,0,1,1,0,0,0,0,0,0,0,0,0,0
,,Asian,58,31,27,56,29,27,27,27,0,12,12,0,8,8,0,6,6,0,3,3,0
,,American Indian/Alaska Native,7,7,0,6,6,0,5,5,0,3,3,0,2,2,0,0,0,0,0,0,0
,,Pacific Islander,4,4,0,4,4,0,4,4,0,2,2,0,1,1,0,3,3,0,1,1,0
,,Multiracial,15,7,8,13,6,7,7,6,1,3,3,0,2,2,0,2,2,0,0,0,0
,Texas,All Ethnicities,28137,17342,10795,26064,15560,10504,14257,13995,262,6831,6829,2,2616,2615,1,3483,3458,25,209,207,2
,,White,15640,9888,5752,14542,8985,5557,8056,7886,170,3801,3799,2,1503,1502,1,1785,1764,21,95,94,1
,,Black,3401,2355,1046,2996,1960,1036,1994,1984,10,870,870,0,359,359,0,528,528,0,36,36,0
,,Hispanic,8352,4706,3646,7854,4271,3583,3855,3796,59,2033,2033,0,700,700,0,1085,1081,4,72,71,1
,,Unknown,30,27,3,28,25,3,16,16,0,11,11,0,2,2,0,1,1,0,0,0,0
,,Asian,517,297,220,473,260,213,262,255,7,86,86,0,41,41,0,71,71,0,5,5,0
,,American Indian/Alaska Native,38,14,24,35,12,23,12,11,1,6,6,0,2,2,0,4,4,0,0,0,0
,,Pacific Islander,34,10,24,33,9,24,9,9,0,4,4,0,1,1,0,3,3,0,0,0,0
,,Multiracial,125,45,80,103,38,65,53,38,15,20,20,0,8,8,0,6,6,0,1,1,0
,Utah,All Ethnicities,3496,1727,1769,3313,1613,1700,1426,1363,63,703,702,1,375,375,0,259,254,5,13,13,0
,,White,3122,1528,1594,2957,1428,1529,1274,1214,60,621,620,1,341,341,0,227,223,4,12,12,0
,,Black,27,19,8,23,16,7,15,15,0,7,7,0,3,3,0,4,3,1,0,0,0
,,Hispanic,248,133,115,239,125,114,100,99,1,58,58,0,26,26,0,22,22,0,1,1,0
,,Unknown,1,0,1,1,0,1,0,0,0,0,0,0,0,0,0,0,0,0,0,0,0
,,Asian,44,24,20,41,22,19,21,20,1,7,7,0,5,5,0,4,4,0,0,0,0
,,American Indian/Alaska Native,19,8,11,18,7,11,5,5,0,5,5,0,0,0,0,0,0,0,0,0,0
,,Pacific Islander,18,9,9,17,9,8,7,6,1,4,4,0,0,0,0,2,2,0,0,0,0
,,Multiracial,17,6,11,17,6,11,4,4,0,1,1,0,0,0,0,0,0,0,0,0,0
,Vermont,All Ethnicities,798,398,400,746,381,365,350,316,34,138,138,0,85,85,0,62,61,1,3,3,0
,,White,776,388,388,727,373,354,343,310,33,135,135,0,84,84,0,60,59,1,3,3,0
,,Black,11,8,3,9,6,3,5,5,0,2,2,0,1,1,0,1,1,0,0,0,0
,,Hispanic,8,1,7,8,1,7,1,1,0,1,1,0,0,0,0,1,1,0,0,0,0
,,Unknown,1,1,0,1,1,0,0,0,0,0,0,0,0,0,0,0,0,0,0,0,0
,,Asian,1,0,1,0,0,0,1,0,1,0,0,0,0,0,0,0,0,0,0,0,0
,,Pacific Islander,1,0,1,1,0,1,0,0,0,0,0,0,0,0,0,0,0,0,0,0,0
,,,,,,,,,,,,,,,,,,,,,,,
,,,,,,,,,,,,,,,,,,,,,,,
,Virginia,All Ethnicities,10007,4974,5033,9398,4664,4734,4343,4058,285,1762,1761,1,916,915,1,922,912,10,78,75,3
,,White,6997,3529,3468,6540,3333,3207,3124,2875,249,1263,1262,1,656,656,0,613,603,10,44,43,1
,,Black,2178,1076,1102,2066,985,1081,903,883,20,370,370,0,163,163,0,218,218,0,27,26,1
,,Hispanic,425,191,234,400,179,221,168,156,12,74,74,0,57,56,1,47,47,0,5,4,1
,,Asian,339,154,185,326,144,182,128,125,3,43,43,0,33,33,0,38,38,0,2,2,0
,,American Indian/Alaska Native,19,6,13,19,6,13,5,5,0,2,2,0,2,2,0,2,2,0,0,0,0
,,Pacific Islander,15,5,10,15,5,10,3,3,0,3,3,0,1,1,0,2,2,0,0,0,0
,,Multiracial,34,13,21,32,12,20,12,11,1,7,7,0,4,4,0,2,2,0,0,0,0
,Washington,All Ethnicities,6425,3480,2945,6193,3325,2868,2805,2738,67,1217,1214,3,723,723,0,602,595,7,26,26,0
,,White,5366,2887,2479,5173,2764,2409,2311,2251,60,988,985,3,604,604,0,485,478,7,18,18,0
,,Black,242,140,102,230,130,100,124,122,2,57,57,0,34,34,0,31,31,0,3,3,0
,,Hispanic,389,222,167,378,212,166,182,181,1,95,95,0,43,43,0,42,42,0,2,2,0
,,Unknown,5,4,1,4,3,1,4,4,0,2,2,0,1,1,0,0,0,0,0,0,0
,,Asian,246,133,113,235,125,110,107,104,3,36,36,0,23,23,0,27,27,0,1,1,0
,,American Indian/Alaska Native,66,42,24,65,41,24,33,33,0,17,17,0,8,8,0,11,11,0,0,0,0
,,Pacific Islander,41,20,21,41,20,21,17,17,0,5,5,0,4,4,0,0,0,0,1,1,0
,,Multiracial,70,32,38,67,30,37,27,26,1,17,17,0,6,6,0,6,6,0,1,1,0
,West Virginia,All Ethnicities,2429,1603,826,2228,1483,745,1445,1367,78,495,495,0,377,375,2,271,269,2,42,42,0
,,White,2283,1500,783,2097,1393,704,1351,1275,76,451,451,0,350,348,2,245,243,2,40,40,0
,,Black,118,86,32,106,74,32,76,76,0,35,35,0,19,19,0,20,20,0,2,2,0
,,Hispanic,19,15,4,17,14,3,15,14,1,7,7,0,7,7,0,4,4,0,0,0,0
,,Asian,7,2,5,6,2,4,3,2,1,2,2,0,1,1,0,2,2,0,0,0,0
,,Multiracial,2,0,2,2,0,2,0,0,0,0,0,0,0,0,0,0,0,0,0,0,0
,Wisconsin,All Ethnicities,9144,5163,3981,8686,4813,3873,4235,4138,97,1715,1715,0,1895,1890,5,867,857,10,42,42,0
,,White,8131,4517,3614,7768,4252,3516,3685,3598,87,1454,1454,0,1706,1701,5,739,729,10,33,33,0
,,Black,554,398,156,485,333,152,350,346,4,164,164,0,108,108,0,84,84,0,5,5,0
,,Hispanic,286,179,107,267,163,104,144,141,3,72,72,0,59,59,0,32,32,0,3,3,0
,,Unknown,2,0,2,2,0,2,0,0,0,0,0,0,0,0,0,0,0,0,0,0,0
,,Asian,79,41,38,75,38,37,33,32,1,11,11,0,11,11,0,9,9,0,0,0,0
,,American Indian/Alaska Native,63,15,48,60,14,46,14,12,2,6,6,0,8,8,0,2,2,0,0,0,0
,,Pacific Islander,4,2,2,4,2,2,2,2,0,2,2,0,2,2,0,1,1,0,0,0,0
,,Multiracial,25,11,14,25,11,14,7,7,0,6,6,0,1,1,0,0,0,0,1,1,0
,Wyoming,All Ethnicities,686,419,267,647,396,251,360,346,14,184,184,0,112,112,0,75,73,2,1,1,0
,,White,643,394,249,606,372,234,336,323,13,171,171,0,107,107,0,72,70,2,1,1,0
,,Black,5,5,0,5,5,0,5,5,0,4,4,0,0,0,0,1,1,0,0,0,0
,,Hispanic,24,13,11,22,12,10,13,12,1,6,6,0,4,4,0,1,1,0,0,0,0
,,Asian,5,2,3,5,2,3,1,1,0,0,0,0,0,0,0,1,1,0,0,0,0
,,American Indian/Alaska Native,9,5,4,9,5,4,5,5,0,3,3,0,1,1,0,0,0,0,0,0,0
< 1 Year,All Donor States of Residence,All Ethnicities,3386,3384,2,1856,1855,1,2339,2339,0,2337,2336,1,426,426,0,156,156,0,682,682,0
,,White,1908,1906,2,986,985,1,1300,1300,0,1310,1309,1,241,241,0,92,92,0,384,384,0
,,Black,786,786,0,439,439,0,558,558,0,547,547,0,102,102,0,33,33,0,159,159,0
,,,,,,,,,,,,,,,,,,,,,,,
,,,,,,,,,,,,,,,,,,,,,,,
,,Hispanic,569,569,0,354,354,0,397,397,0,401,401,0,67,67,0,25,25,0,118,118,0
,,Unknown,3,3,0,0,0,0,3,3,0,1,1,0,0,0,0,0,0,0,0,0,0
,,Asian,58,58,0,42,42,0,37,37,0,34,34,0,7,7,0,3,3,0,8,8,0
,,American Indian/Alaska Native,16,16,0,7,7,0,12,12,0,10,10,0,6,6,0,1,1,0,6,6,0
,,Pacific Islander,5,5,0,4,4,0,4,4,0,4,4,0,0,0,0,0,0,0,0,0,0
,,Multiracial,41,41,0,24,24,0,28,28,0,30,30,0,3,3,0,2,2,0,7,7,0
,Alabama,All Ethnicities,60,60,0,32,32,0,34,34,0,40,40,0,6,6,0,1,1,0,7,7,0
,,White,36,36,0,20,20,0,18,18,0,22,22,0,4,4,0,1,1,0,5,5,0
,,Black,20,20,0,9,9,0,12,12,0,15,15,0,1,1,0,0,0,0,1,1,0
,,Hispanic,2,2,0,2,2,0,2,2,0,1,1,0,0,0,0,0,0,0,0,0,0
,,Asian,1,1,0,1,1,0,1,1,0,1,1,0,1,1,0,0,0,0,1,1,0
,,Pacific Islander,1,1,0,0,0,0,1,1,0,1,1,0,0,0,0,0,0,0,0,0,0
,Alaska,All Ethnicities,8,8,0,7,7,0,6,6,0,3,3,0,1,1,0,0,0,0,1,1,0
,,White,5,5,0,5,5,0,4,4,0,2,2,0,0,0,0,0,0,0,0,0,0
,,American Indian/Alaska Native,3,3,0,2,2,0,2,2,0,1,1,0,1,1,0,0,0,0,1,1,0
,Arizona,All Ethnicities,52,52,0,39,39,0,32,32,0,33,33,0,3,3,0,4,4,0,4,4,0
,,White,28,28,0,19,19,0,16,16,0,19,19,0,3,3,0,4,4,0,3,3,0
,,Black,10,10,0,6,6,0,7,7,0,5,5,0,0,0,0,0,0,0,0,0,0
,,Hispanic,13,13,0,13,13,0,8,8,0,8,8,0,0,0,0,0,0,0,1,1,0
,,Multiracial,1,1,0,1,1,0,1,1,0,1,1,0,0,0,0,0,0,0,0,0,0
,Arkansas,All Ethnicities,42,42,0,20,20,0,31,31,0,32,32,0,10,10,0,0,0,0,12,12,0
,,White,25,25,0,12,12,0,19,19,0,19,19,0,4,4,0,0,0,0,5,5,0
,,Black,13,13,0,6,6,0,9,9,0,10,10,0,5,5,0,0,0,0,6,6,0
,,Hispanic,4,4,0,2,2,0,3,3,0,3,3,0,1,1,0,0,0,0,1,1,0
,California,All Ethnicities,334,334,0,202,202,0,216,216,0,241,241,0,19,19,0,12,12,0,34,34,0
,,White,132,132,0,64,64,0,84,84,0,97,97,0,5,5,0,6,6,0,7,7,0
,,Black,39,39,0,26,26,0,24,24,0,24,24,0,1,1,0,0,0,0,2,2,0
,,Hispanic,134,134,0,91,91,0,92,92,0,102,102,0,11,11,0,4,4,0,23,23,0
,,Unknown,1,1,0,0,0,0,1,1,0,0,0,0,0,0,0,0,0,0,0,0,0
,,Asian,20,20,0,16,16,0,12,12,0,13,13,0,1,1,0,2,2,0,1,1,0
,,American Indian/Alaska Native,2,2,0,1,1,0,1,1,0,1,1,0,1,1,0,0,0,0,1,1,0
,,Multiracial,6,6,0,4,4,0,2,2,0,4,4,0,0,0,0,0,0,0,0,0,0
,Colorado,All Ethnicities,51,51,0,23,23,0,31,31,0,37,37,0,6,6,0,0,0,0,10,10,0
,,White,34,34,0,17,17,0,22,22,0,25,25,0,4,4,0,0,0,0,7,7,0
,,Black,4,4,0,2,2,0,2,2,0,3,3,0,0,0,0,0,0,0,0,0,0
,,Hispanic,11,11,0,4,4,0,5,5,0,7,7,0,2,2,0,0,0,0,3,3,0
,,American Indian/Alaska Native,2,2,0,0,0,0,2,2,0,2,2,0,0,0,0,0,0,0,0,0,0
,Connecticut,All Ethnicities,23,23,0,18,18,0,18,18,0,16,16,0,2,2,0,1,1,0,3,3,0
,,White,9,9,0,7,7,0,7,7,0,6,6,0,0,0,0,0,0,0,0,0,0
,,Black,6,6,0,5,5,0,6,6,0,5,5,0,0,0,0,0,0,0,0,0,0
,,Hispanic,8,8,0,6,6,0,5,5,0,5,5,0,2,2,0,1,1,0,3,3,0
,,,,,,,,,,,,,,,,,,,,,,,
,,,,,,,,,,,,,,,,,,,,,,,
,Delaware,All Ethnicities,8,8,0,5,5,0,7,7,0,5,5,0,0,0,0,0,0,0,1,1,0
,,White,4,4,0,3,3,0,3,3,0,3,3,0,0,0,0,0,0,0,0,0,0
,,Black,4,4,0,2,2,0,4,4,0,2,2,0,0,0,0,0,0,0,1,1,0
,District of Columbia,All Ethnicities,8,8,0,6,6,0,8,8,0,6,6,0,1,1,0,1,1,0,1,1,0
,,White,3,3,0,2,2,0,3,3,0,1,1,0,1,1,0,1,1,0,1,1,0
,,Black,5,5,0,4,4,0,5,5,0,5,5,0,0,0,0,0,0,0,0,0,0
,Florida,All Ethnicities,224,224,0,98,98,0,170,170,0,149,149,0,54,54,0,12,12,0,67,67,0
,,White,110,110,0,42,42,0,83,83,0,78,78,0,20,20,0,6,6,0,27,27,0
,,Black,64,64,0,30,30,0,47,47,0,37,37,0,14,14,0,2,2,0,17,17,0
,,Hispanic,46,46,0,23,23,0,37,37,0,31,31,0,19,19,0,4,4,0,22,22,0
,,Asian,2,2,0,1,1,0,1,1,0,2,2,0,1,1,0,0,0,0,1,1,0
,,Multiracial,2,2,0,2,2,0,2,2,0,1,1,0,0,0,0,0,0,0,0,0,0
,Georgia,All Ethnicities,110,110,0,48,48,0,77,77,0,92,92,0,18,18,0,4,4,0,31,31,0
,,White,50,50,0,21,21,0,39,39,0,39,39,0,9,9,0,2,2,0,14,14,0
,,Black,49,49,0,23,23,0,30,30,0,45,45,0,9,9,0,2,2,0,13,13,0
,,Hispanic,10,10,0,4,4,0,7,7,0,7,7,0,0,0,0,0,0,0,3,3,0
,,Multiracial,1,1,0,0,0,0,1,1,0,1,1,0,0,0,0,0,0,0,1,1,0
,Hawaii,All Ethnicities,7,7,0,4,4,0,4,4,0,3,3,0,1,1,0,0,0,0,1,1,0
,,White,1,1,0,0,0,0,1,1,0,0,0,0,0,0,0,0,0,0,0,0,0
,,Black,1,1,0,1,1,0,0,0,0,0,0,0,0,0,0,0,0,0,0,0,0
,,Hispanic,1,1,0,1,1,0,0,0,0,0,0,0,0,0,0,0,0,0,0,0,0
,,Asian,2,2,0,1,1,0,1,1,0,2,2,0,1,1,0,0,0,0,1,1,0
,,Pacific Islander,1,1,0,1,1,0,1,1,0,1,1,0,0,0,0,0,0,0,0,0,0
,,Multiracial,1,1,0,0,0,0,1,1,0,0,0,0,0,0,0,0,0,0,0,0,0
,Idaho,All Ethnicities,20,20,0,12,12,0,13,13,0,13,13,0,3,3,0,1,1,0,5,5,0
,,White,15,15,0,8,8,0,10,10,0,10,10,0,2,2,0,0,0,0,4,4,0
,,Black,1,1,0,1,1,0,0,0,0,0,0,0,0,0,0,0,0,0,0,0,0
,,Hispanic,3,3,0,2,2,0,2,2,0,2,2,0,0,0,0,1,1,0,0,0,0
,,American Indian/Alaska Native,1,1,0,1,1,0,1,1,0,1,1,0,1,1,0,0,0,0,1,1,0
,Illinois,All Ethnicities,170,170,0,91,91,0,116,116,0,104,104,0,14,14,0,10,10,0,29,29,0
,,White,87,87,0,46,46,0,52,52,0,50,50,0,9,9,0,4,4,0,15,15,0
,,Black,59,59,0,31,31,0,48,48,0,39,39,0,3,3,0,5,5,0,8,8,0
,,Hispanic,17,17,0,9,9,0,11,11,0,10,10,0,2,2,0,0,0,0,5,5,0
,,Asian,4,4,0,3,3,0,3,3,0,2,2,0,0,0,0,1,1,0,0,0,0
,,Multiracial,3,3,0,2,2,0,2,2,0,3,3,0,0,0,0,0,0,0,1,1,0
,Indiana,All Ethnicities,75,75,0,41,41,0,54,54,0,58,58,0,17,17,0,4,4,0,20,20,0
,,White,56,56,0,29,29,0,41,41,0,44,44,0,11,11,0,3,3,0,14,14,0
,,Black,15,15,0,9,9,0,9,9,0,11,11,0,5,5,0,1,1,0,5,5,0
,,Hispanic,3,3,0,3,3,0,3,3,0,2,2,0,1,1,0,0,0,0,1,1,0
,,Multiracial,1,1,0,0,0,0,1,1,0,1,1,0,0,0,0,0,0,0,0,0,0
,Iowa,All Ethnicities,30,30,0,17,17,0,23,23,0,22,22,0,6,6,0,1,1,0,10,10,0
,,,,,,,,,,,,,,,,,,,,,,,
,,,,,,,,,,,,,,,,,,,,,,,
,,White,21,21,0,14,14,0,16,16,0,14,14,0,3,3,0,0,0,0,5,5,0
,,Black,6,6,0,2,2,0,5,5,0,6,6,0,2,2,0,0,0,0,3,3,0
,,Hispanic,3,3,0,1,1,0,2,2,0,2,2,0,1,1,0,1,1,0,2,2,0
,Kansas,All Ethnicities,53,53,0,31,31,0,34,34,0,35,35,0,7,7,0,1,1,0,15,15,0
,,White,41,41,0,22,22,0,24,24,0,26,26,0,4,4,0,0,0,0,11,11,0
,,Black,4,4,0,3,3,0,3,3,0,3,3,0,1,1,0,1,1,0,1,1,0
,,Hispanic,6,6,0,5,5,0,5,5,0,4,4,0,2,2,0,0,0,0,2,2,0
,,Asian,2,2,0,1,1,0,2,2,0,2,2,0,0,0,0,0,0,0,1,1,0
,Kentucky,All Ethnicities,50,50,0,27,27,0,45,45,0,40,40,0,8,8,0,0,0,0,14,14,0
,,White,42,42,0,22,22,0,37,37,0,35,35,0,6,6,0,0,0,0,11,11,0
,,Black,6,6,0,4,4,0,6,6,0,4,4,0,2,2,0,0,0,0,3,3,0
,,Hispanic,2,2,0,1,1,0,2,2,0,1,1,0,0,0,0,0,0,0,0,0,0
,Louisiana,All Ethnicities,54,54,0,23,23,0,45,45,0,40,40,0,12,12,0,3,3,0,17,17,0
,,White,27,27,0,12,12,0,23,23,0,21,21,0,7,7,0,0,0,0,10,10,0
,,Black,26,26,0,10,10,0,21,21,0,18,18,0,5,5,0,3,3,0,7,7,0
,,Hispanic,1,1,0,1,1,0,1,1,0,1,1,0,0,0,0,0,0,0,0,0,0
,Maine,All Ethnicities,8,8,0,6,6,0,7,7,0,5,5,0,7,7,0,1,1,0,7,7,0
,,White,8,8,0,6,6,0,7,7,0,5,5,0,7,7,0,1,1,0,7,7,0
,Maryland,All Ethnicities,54,54,0,40,40,0,40,40,0,33,33,0,10,10,0,3,3,0,11,11,0
,,White,27,27,0,20,20,0,19,19,0,17,17,0,5,5,0,3,3,0,6,6,0
,,Black,19,19,0,12,12,0,15,15,0,11,11,0,4,4,0,0,0,0,4,4,0
,,Hispanic,5,5,0,5,5,0,4,4,0,3,3,0,1,1,0,0,0,0,1,1,0
,,Asian,3,3,0,3,3,0,2,2,0,2,2,0,0,0,0,0,0,0,0,0,0
,Massachusetts,All Ethnicities,32,32,0,17,17,0,21,21,0,20,20,0,2,2,0,2,2,0,9,9,0
,,White,23,23,0,12,12,0,13,13,0,14,14,0,0,0,0,0,0,0,5,5,0
,,Black,1,1,0,1,1,0,1,1,0,0,0,0,0,0,0,1,1,0,1,1,0
,,Hispanic,6,6,0,3,3,0,5,5,0,4,4,0,1,1,0,1,1,0,2,2,0
,,Asian,1,1,0,1,1,0,1,1,0,1,1,0,0,0,0,0,0,0,0,0,0
,,Multiracial,1,1,0,0,0,0,1,1,0,1,1,0,1,1,0,0,0,0,1,1,0
,Michigan,All Ethnicities,109,109,0,59,59,0,72,72,0,79,79,0,16,16,0,4,4,0,29,29,0
,,White,68,68,0,34,34,0,47,47,0,47,47,0,9,9,0,4,4,0,18,18,0
,,Black,33,33,0,20,20,0,19,19,0,26,26,0,7,7,0,0,0,0,8,8,0
,,Hispanic,8,8,0,5,5,0,6,6,0,6,6,0,0,0,0,0,0,0,3,3,0
,Minnesota,All Ethnicities,59,59,0,26,26,0,41,41,0,42,42,0,7,7,0,4,4,0,10,10,0
,,White,45,45,0,21,21,0,32,32,0,31,31,0,4,4,0,2,2,0,6,6,0
,,Black,5,5,0,2,2,0,4,4,0,4,4,0,0,0,0,1,1,0,0,0,0
,,Hispanic,5,5,0,3,3,0,3,3,0,3,3,0,1,1,0,0,0,0,2,2,0
,,Asian,1,1,0,0,0,0,0,0,0,1,1,0,0,0,0,0,0,0,0,0,0
,,American Indian/Alaska Native,1,1,0,0,0,0,1,1,0,1,1,0,1,1,0,0,0,0,1,1,0
,,Multiracial,2,2,0,0,0,0,1,1,0,2,2,0,1,1,0,1,1,0,1,1,0
,Mississippi,All Ethnicities,43,43,0,22,22,0,32,32,0,26,26,0,10,10,0,3,3,0,13,13,0
,,,,,,,,,,,,,,,,,,,,,,,
,,,,,,,,,,,,,,,,,,,,,,,
,,White,24,24,0,13,13,0,15,15,0,15,15,0,6,6,0,2,2,0,6,6,0
,,Black,16,16,0,8,8,0,15,15,0,8,8,0,4,4,0,1,1,0,7,7,0
,,Hispanic,2,2,0,0,0,0,1,1,0,2,2,0,0,0,0,0,0,0,0,0,0
,,Asian,1,1,0,1,1,0,1,1,0,1,1,0,0,0,0,0,0,0,0,0,0
,Missouri,All Ethnicities,80,80,0,39,39,0,51,51,0,53,53,0,12,12,0,6,6,0,20,20,0
,,White,51,51,0,23,23,0,30,30,0,37,37,0,10,10,0,5,5,0,15,15,0
,,Black,25,25,0,14,14,0,18,18,0,15,15,0,1,1,0,1,1,0,4,4,0
,,Hispanic,4,4,0,2,2,0,3,3,0,1,1,0,1,1,0,0,0,0,1,1,0
,Montana,All Ethnicities,14,14,0,7,7,0,11,11,0,12,12,0,2,2,0,0,0,0,4,4,0
,,White,12,12,0,6,6,0,10,10,0,11,11,0,1,1,0,0,0,0,3,3,0
,,American Indian/Alaska Native,2,2,0,1,1,0,1,1,0,1,1,0,1,1,0,0,0,0,1,1,0
,Nebraska,All Ethnicities,24,24,0,8,8,0,19,19,0,13,13,0,4,4,0,2,2,0,7,7,0
,,White,21,21,0,6,6,0,17,17,0,10,10,0,3,3,0,2,2,0,6,6,0
,,Hispanic,2,2,0,1,1,0,1,1,0,2,2,0,1,1,0,0,0,0,1,1,0
,,American Indian/Alaska Native,1,1,0,1,1,0,1,1,0,1,1,0,0,0,0,0,0,0,0,0,0
,Nevada,All Ethnicities,35,35,0,31,31,0,21,21,0,24,24,0,2,2,0,0,0,0,4,4,0
,,White,17,17,0,16,16,0,8,8,0,9,9,0,1,1,0,0,0,0,3,3,0
,,Black,8,8,0,8,8,0,6,6,0,7,7,0,0,0,0,0,0,0,0,0,0
,,Hispanic,10,10,0,7,7,0,7,7,0,8,8,0,1,1,0,0,0,0,1,1,0
,New Hampshire,All Ethnicities,5,5,0,3,3,0,5,5,0,2,2,0,0,0,0,1,1,0,0,0,0
,,White,5,5,0,3,3,0,5,5,0,2,2,0,0,0,0,1,1,0,0,0,0
,New Jersey,All Ethnicities,69,69,0,44,44,0,43,43,0,47,47,0,6,6,0,5,5,0,11,11,0
,,White,29,29,0,14,14,0,16,16,0,23,23,0,4,4,0,1,1,0,6,6,0
,,Black,19,19,0,13,13,0,15,15,0,13,13,0,2,2,0,2,2,0,3,3,0
,,Hispanic,16,16,0,12,12,0,8,8,0,9,9,0,0,0,0,2,2,0,2,2,0
,,Asian,3,3,0,3,3,0,2,2,0,1,1,0,0,0,0,0,0,0,0,0,0
,,Multiracial,2,2,0,2,2,0,2,2,0,1,1,0,0,0,0,0,0,0,0,0,0
,New Mexico,All Ethnicities,26,26,0,13,13,0,21,21,0,19,19,0,3,3,0,1,1,0,3,3,0
,,White,11,11,0,6,6,0,7,7,0,7,7,0,2,2,0,0,0,0,3,3,0
,,Hispanic,14,14,0,7,7,0,13,13,0,11,11,0,1,1,0,1,1,0,0,0,0
,,American Indian/Alaska Native,1,1,0,0,0,0,1,1,0,1,1,0,0,0,0,0,0,0,0,0,0
,New York,All Ethnicities,137,137,0,71,71,0,95,95,0,96,96,0,19,19,0,7,7,0,34,34,0
,,White,64,64,0,24,24,0,47,47,0,46,46,0,10,10,0,2,2,0,19,19,0
,,Black,34,34,0,21,21,0,25,25,0,23,23,0,4,4,0,2,2,0,9,9,0
,,Hispanic,32,32,0,21,21,0,18,18,0,23,23,0,3,3,0,3,3,0,4,4,0
,,Asian,4,4,0,3,3,0,2,2,0,2,2,0,1,1,0,0,0,0,1,1,0
,,Multiracial,3,3,0,2,2,0,3,3,0,2,2,0,1,1,0,0,0,0,1,1,0
,North Carolina,All Ethnicities,125,125,0,61,61,0,94,94,0,87,87,0,14,14,0,7,7,0,33,33,0
,,White,67,67,0,31,31,0,50,50,0,48,48,0,8,8,0,4,4,0,17,17,0
,,Black,48,48,0,24,24,0,34,34,0,33,33,0,4,4,0,2,2,0,12,12,0
,,Hispanic,7,7,0,4,4,0,7,7,0,5,5,0,1,1,0,0,0,0,3,3,0
,,,,,,,,,,,,,,,,,,,,,,,
,,,,,,,,,,,,,,,,,,,,,,,
,,Asian,1,1,0,1,1,0,1,1,0,0,0,0,0,0,0,0,0,0,0,0,0
,,American Indian/Alaska Native,1,1,0,1,1,0,1,1,0,0,0,0,1,1,0,0,0,0,1,1,0
,,Multiracial,1,1,0,0,0,0,1,1,0,1,1,0,0,0,0,1,1,0,0,0,0
,North Dakota,All Ethnicities,5,5,0,3,3,0,3,3,0,5,5,0,0,0,0,0,0,0,0,0,0
,,White,5,5,0,3,3,0,3,3,0,5,5,0,0,0,0,0,0,0,0,0,0
,Ohio,All Ethnicities,111,110,1,58,58,0,76,76,0,79,78,1,14,14,0,8,8,0,21,21,0
,,White,86,85,1,44,44,0,58,58,0,58,57,1,10,10,0,8,8,0,16,16,0
,,Black,18,18,0,9,9,0,13,13,0,15,15,0,3,3,0,0,0,0,4,4,0
,,Hispanic,4,4,0,3,3,0,3,3,0,4,4,0,1,1,0,0,0,0,1,1,0
,,Asian,1,1,0,1,1,0,1,1,0,0,0,0,0,0,0,0,0,0,0,0,0
,,Multiracial,2,2,0,1,1,0,1,1,0,2,2,0,0,0,0,0,0,0,0,0,0
,Oklahoma,All Ethnicities,43,42,1,29,28,1,28,28,0,29,29,0,3,3,0,1,1,0,7,7,0
,,White,36,35,1,23,22,1,22,22,0,22,22,0,2,2,0,1,1,0,6,6,0
,,Black,4,4,0,4,4,0,3,3,0,4,4,0,1,1,0,0,0,0,1,1,0
,,Hispanic,2,2,0,1,1,0,2,2,0,2,2,0,0,0,0,0,0,0,0,0,0
,,Multiracial,1,1,0,1,1,0,1,1,0,1,1,0,0,0,0,0,0,0,0,0,0
,Oregon,All Ethnicities,31,31,0,16,16,0,18,18,0,22,22,0,2,2,0,1,1,0,3,3,0
,,White,23,23,0,13,13,0,15,15,0,17,17,0,2,2,0,1,1,0,3,3,0
,,Black,2,2,0,1,1,0,0,0,0,1,1,0,0,0,0,0,0,0,0,0,0
,,Hispanic,4,4,0,1,1,0,1,1,0,4,4,0,0,0,0,0,0,0,0,0,0
,,American Indian/Alaska Native,1,1,0,0,0,0,1,1,0,0,0,0,0,0,0,0,0,0,0,0,0
,,Multiracial,1,1,0,1,1,0,1,1,0,0,0,0,0,0,0,0,0,0,0,0,0
,Pennsylvania,All Ethnicities,155,155,0,92,92,0,100,100,0,93,93,0,15,15,0,11,11,0,25,25,0
,,White,102,102,0,62,62,0,70,70,0,60,60,0,11,11,0,8,8,0,20,20,0
,,Black,33,33,0,21,21,0,22,22,0,19,19,0,2,2,0,2,2,0,2,2,0
,,Hispanic,14,14,0,7,7,0,6,6,0,11,11,0,2,2,0,0,0,0,3,3,0
,,Asian,5,5,0,2,2,0,2,2,0,2,2,0,0,0,0,0,0,0,0,0,0
,,American Indian/Alaska Native,1,1,0,0,0,0,0,0,0,1,1,0,0,0,0,1,1,0,0,0,0
,Puerto Rico,All Ethnicities,9,9,0,7,7,0,7,7,0,6,6,0,0,0,0,0,0,0,0,0,0
,,Hispanic,6,6,0,6,6,0,5,5,0,4,4,0,0,0,0,0,0,0,0,0,0
,,Multiracial,3,3,0,1,1,0,2,2,0,2,2,0,0,0,0,0,0,0,0,0,0
,Rhode Island,All Ethnicities,1,1,0,0,0,0,0,0,0,1,1,0,0,0,0,0,0,0,0,0,0
,,White,1,1,0,0,0,0,0,0,0,1,1,0,0,0,0,0,0,0,0,0,0
,South Carolina,All Ethnicities,34,34,0,20,20,0,28,28,0,28,28,0,11,11,0,1,1,0,16,16,0
,,White,21,21,0,11,11,0,17,17,0,17,17,0,8,8,0,0,0,0,11,11,0
,,Black,13,13,0,9,9,0,11,11,0,11,11,0,3,3,0,1,1,0,5,5,0
,South Dakota,All Ethnicities,5,5,0,2,2,0,1,1,0,4,4,0,0,0,0,0,0,0,0,0,0
,,White,5,5,0,2,2,0,1,1,0,4,4,0,0,0,0,0,0,0,0,0,0
,State unassigned,All Ethnicities,42,42,0,17,17,0,27,27,0,26,26,0,1,1,0,0,0,0,3,3,0
,,White,20,20,0,8,8,0,13,13,0,12,12,0,0,0,0,0,0,0,1,1,0
,,Black,11,11,0,6,6,0,8,8,0,6,6,0,1,1,0,0,0,0,2,2,0
,,,,,,,,,,,,,,,,,,,,,,,
,,,,,,,,,,,,,,,,,,,,,,,
,,Hispanic,11,11,0,3,3,0,6,6,0,8,8,0,0,0,0,0,0,0,0,0,0
,Tennessee,All Ethnicities,102,102,0,57,57,0,75,75,0,80,80,0,16,16,0,6,6,0,26,26,0
,,White,69,69,0,40,40,0,50,50,0,54,54,0,10,10,0,6,6,0,16,16,0
,,Black,27,27,0,15,15,0,20,20,0,20,20,0,5,5,0,0,0,0,7,7,0
,,Hispanic,5,5,0,2,2,0,4,4,0,5,5,0,0,0,0,0,0,0,2,2,0
,,Asian,1,1,0,0,0,0,1,1,0,1,1,0,1,1,0,0,0,0,1,1,0
,Texas,All Ethnicities,343,343,0,187,187,0,242,242,0,228,228,0,29,29,0,15,15,0,57,57,0
,,White,127,127,0,61,61,0,90,90,0,85,85,0,11,11,0,3,3,0,22,22,0
,,Black,88,88,0,51,51,0,57,57,0,59,59,0,7,7,0,5,5,0,13,13,0
,,Hispanic,121,121,0,73,73,0,90,90,0,81,81,0,10,10,0,7,7,0,21,21,0
,,Unknown,2,2,0,0,0,0,2,2,0,1,1,0,0,0,0,0,0,0,0,0,0
,,Asian,4,4,0,2,2,0,3,3,0,1,1,0,1,1,0,0,0,0,1,1,0
,,Multiracial,1,1,0,0,0,0,0,0,0,1,1,0,0,0,0,0,0,0,0,0,0
,Utah,All Ethnicities,56,56,0,45,45,0,29,29,0,35,35,0,3,3,0,1,1,0,5,5,0
,,White,41,41,0,33,33,0,21,21,0,24,24,0,3,3,0,1,1,0,4,4,0
,,Black,2,2,0,0,0,0,0,0,0,2,2,0,0,0,0,0,0,0,0,0,0
,,Hispanic,9,9,0,8,8,0,5,5,0,7,7,0,0,0,0,0,0,0,1,1,0
,,Pacific Islander,2,2,0,2,2,0,1,1,0,1,1,0,0,0,0,0,0,0,0,0,0
,,Multiracial,2,2,0,2,2,0,2,2,0,1,1,0,0,0,0,0,0,0,0,0,0
,Vermont,All Ethnicities,4,4,0,2,2,0,4,4,0,1,1,0,1,1,0,0,0,0,0,0,0
,,White,3,3,0,2,2,0,3,3,0,0,0,0,1,1,0,0,0,0,0,0,0
,,Black,1,1,0,0,0,0,1,1,0,1,1,0,0,0,0,0,0,0,0,0,0
,Virginia,All Ethnicities,81,81,0,48,48,0,56,56,0,59,59,0,10,10,0,6,6,0,15,15,0
,,White,45,45,0,25,25,0,33,33,0,33,33,0,6,6,0,5,5,0,8,8,0
,,Black,28,28,0,18,18,0,19,19,0,23,23,0,4,4,0,1,1,0,6,6,0
,,Hispanic,4,4,0,2,2,0,3,3,0,2,2,0,0,0,0,0,0,0,1,1,0
,,Asian,1,1,0,1,1,0,0,0,0,0,0,0,0,0,0,0,0,0,0,0,0
,,Multiracial,3,3,0,2,2,0,1,1,0,1,1,0,0,0,0,0,0,0,0,0,0
,Washington,All Ethnicities,63,63,0,36,36,0,37,37,0,40,40,0,5,5,0,1,1,0,8,8,0
,,White,48,48,0,26,26,0,25,25,0,31,31,0,4,4,0,1,1,0,5,5,0
,,Black,4,4,0,2,2,0,3,3,0,2,2,0,0,0,0,0,0,0,1,1,0
,,Hispanic,8,8,0,6,6,0,6,6,0,5,5,0,1,1,0,0,0,0,1,1,0
,,Asian,1,1,0,1,1,0,1,1,0,0,0,0,0,0,0,0,0,0,0,0,0
,,Pacific Islander,1,1,0,1,1,0,1,1,0,1,1,0,0,0,0,0,0,0,0,0,0
,,Multiracial,1,1,0,0,0,0,1,1,0,1,1,0,0,0,0,0,0,0,1,1,0
,West Virginia,All Ethnicities,17,17,0,11,11,0,16,16,0,13,13,0,6,6,0,3,3,0,7,7,0
,,White,15,15,0,10,10,0,14,14,0,11,11,0,6,6,0,3,3,0,7,7,0
,,Black,1,1,0,0,0,0,1,1,0,1,1,0,0,0,0,0,0,0,0,0,0
,,Hispanic,1,1,0,1,1,0,1,1,0,1,1,0,0,0,0,0,0,0,0,0,0
,Wisconsin,All Ethnicities,75,75,0,31,31,0,51,51,0,53,53,0,8,8,0,1,1,0,12,12,0
,,White,53,53,0,19,19,0,36,36,0,35,35,0,5,5,0,1,1,0,6,6,0
,,,,,,,,,,,,,,,,,,,,,,,
,,,,,,,,,,,,,,,,,,,,,,,
,,Black,14,14,0,6,6,0,10,10,0,11,11,0,2,2,0,0,0,0,3,3,0
,,Hispanic,5,5,0,3,3,0,4,4,0,4,4,0,1,1,0,0,0,0,2,2,0
,,Multiracial,3,3,0,3,3,0,1,1,0,3,3,0,0,0,0,0,0,0,1,1,0
,Wyoming,All Ethnicities,10,10,0,4,4,0,4,4,0,8,8,0,0,0,0,0,0,0,0,0,0
,,White,10,10,0,4,4,0,4,4,0,8,8,0,0,0,0,0,0,0,0,0,0
1-5 Years,All Donor States of Residence,All Ethnicities,6694,6692,2,6183,6183,0,5363,5362,1,2956,2955,1,541,541,0,301,301,0,789,789,0
,,White,4111,4109,2,3798,3798,0,3285,3284,1,1658,1657,1,339,339,0,176,176,0,468,468,0
,,Black,1282,1282,0,1175,1175,0,1013,1013,0,614,614,0,127,127,0,75,75,0,170,170,0
,,Hispanic,1058,1058,0,981,981,0,863,863,0,572,572,0,65,65,0,39,39,0,123,123,0
,,Unknown,12,12,0,11,11,0,10,10,0,3,3,0,0,0,0,0,0,0,2,2,0
,,Asian,109,109,0,102,102,0,89,89,0,46,46,0,2,2,0,5,5,0,13,13,0
,,American Indian/Alaska Native,28,28,0,26,26,0,24,24,0,14,14,0,3,3,0,1,1,0,1,1,0
,,Pacific Islander,14,14,0,13,13,0,9,9,0,4,4,0,0,0,0,1,1,0,1,1,0
,,Multiracial,80,80,0,77,77,0,70,70,0,45,45,0,5,5,0,4,4,0,11,11,0
,Alabama,All Ethnicities,106,106,0,98,98,0,88,88,0,45,45,0,6,6,0,4,4,0,12,12,0
,,White,74,74,0,69,69,0,62,62,0,30,30,0,4,4,0,4,4,0,8,8,0
,,Black,28,28,0,25,25,0,24,24,0,12,12,0,2,2,0,0,0,0,4,4,0
,,Hispanic,3,3,0,3,3,0,1,1,0,2,2,0,0,0,0,0,0,0,0,0,0
,,Asian,1,1,0,1,1,0,1,1,0,1,1,0,0,0,0,0,0,0,0,0,0
,Alaska,All Ethnicities,27,27,0,25,25,0,20,20,0,7,7,0,1,1,0,0,0,0,0,0,0
,,White,24,24,0,22,22,0,17,17,0,4,4,0,1,1,0,0,0,0,0,0,0
,,American Indian/Alaska Native,2,2,0,2,2,0,2,2,0,2,2,0,0,0,0,0,0,0,0,0,0
,,Multiracial,1,1,0,1,1,0,1,1,0,1,1,0,0,0,0,0,0,0,0,0,0
,Arizona,All Ethnicities,141,141,0,133,133,0,117,117,0,71,71,0,5,5,0,3,3,0,14,14,0
,,White,77,77,0,71,71,0,62,62,0,35,35,0,1,1,0,2,2,0,4,4,0
,,Black,12,12,0,12,12,0,10,10,0,7,7,0,0,0,0,0,0,0,1,1,0
,,Hispanic,40,40,0,38,38,0,34,34,0,21,21,0,4,4,0,0,0,0,8,8,0
,,Asian,6,6,0,6,6,0,5,5,0,4,4,0,0,0,0,1,1,0,0,0,0
,,American Indian/Alaska Native,4,4,0,4,4,0,4,4,0,2,2,0,0,0,0,0,0,0,0,0,0
,,Multiracial,2,2,0,2,2,0,2,2,0,2,2,0,0,0,0,0,0,0,1,1,0
,Arkansas,All Ethnicities,59,59,0,56,56,0,45,45,0,27,27,0,6,6,0,3,3,0,6,6,0
,,White,43,43,0,42,42,0,36,36,0,17,17,0,4,4,0,2,2,0,5,5,0
,,Black,10,10,0,8,8,0,7,7,0,6,6,0,2,2,0,1,1,0,1,1,0
,,Hispanic,4,4,0,4,4,0,1,1,0,2,2,0,0,0,0,0,0,0,0,0,0
,,Multiracial,2,2,0,2,2,0,1,1,0,2,2,0,0,0,0,0,0,0,0,0,0
,California,All Ethnicities,639,639,0,575,575,0,520,520,0,317,317,0,21,21,0,24,24,0,45,45,0
,,White,294,294,0,263,263,0,231,231,0,123,123,0,10,10,0,13,13,0,19,19,0
,,Black,61,61,0,56,56,0,53,53,0,28,28,0,2,2,0,2,2,0,6,6,0
,,Hispanic,248,248,0,223,223,0,208,208,0,149,149,0,8,8,0,8,8,0,18,18,0
,,Unknown,1,1,0,1,1,0,1,1,0,1,1,0,0,0,0,0,0,0,0,0,0
,,Asian,19,19,0,16,16,0,16,16,0,6,6,0,1,1,0,1,1,0,2,2,0
,,,,,,,,,,,,,,,,,,,,,,,
,,,,,,,,,,,,,,,,,,,,,,,
,,American Indian/Alaska Native,1,1,0,1,1,0,0,0,0,0,0,0,0,0,0,0,0,0,0,0,0
,,Pacific Islander,2,2,0,2,2,0,1,1,0,1,1,0,0,0,0,0,0,0,0,0,0
,,Multiracial,13,13,0,13,13,0,10,10,0,9,9,0,0,0,0,0,0,0,0,0,0
,Colorado,All Ethnicities,75,75,0,64,64,0,57,57,0,32,32,0,3,3,0,2,2,0,9,9,0
,,White,55,55,0,49,49,0,41,41,0,22,22,0,2,2,0,0,0,0,6,6,0
,,Black,4,4,0,2,2,0,3,3,0,3,3,0,0,0,0,1,1,0,0,0,0
,,Hispanic,15,15,0,12,12,0,12,12,0,6,6,0,1,1,0,1,1,0,3,3,0
,,Asian,1,1,0,1,1,0,1,1,0,1,1,0,0,0,0,0,0,0,0,0,0
,Connecticut,All Ethnicities,43,43,0,41,41,0,32,32,0,15,15,0,3,3,0,4,4,0,7,7,0
,,White,21,21,0,19,19,0,16,16,0,6,6,0,2,2,0,1,1,0,4,4,0
,,Black,7,7,0,7,7,0,5,5,0,3,3,0,1,1,0,1,1,0,1,1,0
,,Hispanic,11,11,0,11,11,0,8,8,0,3,3,0,0,0,0,1,1,0,1,1,0
,,Asian,3,3,0,3,3,0,2,2,0,2,2,0,0,0,0,1,1,0,0,0,0
,,Multiracial,1,1,0,1,1,0,1,1,0,1,1,0,0,0,0,0,0,0,1,1,0
,Delaware,All Ethnicities,19,19,0,19,19,0,15,15,0,7,7,0,0,0,0,1,1,0,1,1,0
,,White,11,11,0,11,11,0,9,9,0,3,3,0,0,0,0,0,0,0,0,0,0
,,Black,2,2,0,2,2,0,2,2,0,2,2,0,0,0,0,1,1,0,0,0,0
,,Hispanic,5,5,0,5,5,0,4,4,0,2,2,0,0,0,0,0,0,0,1,1,0
,,Asian,1,1,0,1,1,0,0,0,0,0,0,0,0,0,0,0,0,0,0,0,0
,District of Columbia,All Ethnicities,7,7,0,7,7,0,5,5,0,3,3,0,1,1,0,0,0,0,0,0,0
,,White,1,1,0,1,1,0,1,1,0,0,0,0,1,1,0,0,0,0,0,0,0
,,Black,6,6,0,6,6,0,4,4,0,3,3,0,0,0,0,0,0,0,0,0,0
,Florida,All Ethnicities,487,487,0,452,452,0,411,411,0,195,195,0,89,89,0,16,16,0,86,86,0
,,White,260,260,0,239,239,0,214,214,0,93,93,0,48,48,0,10,10,0,45,45,0
,,Black,116,116,0,107,107,0,105,105,0,51,51,0,23,23,0,1,1,0,23,23,0
,,Hispanic,103,103,0,98,98,0,84,84,0,47,47,0,18,18,0,5,5,0,17,17,0
,,Asian,4,4,0,4,4,0,4,4,0,3,3,0,0,0,0,0,0,0,1,1,0
,,American Indian/Alaska Native,1,1,0,1,1,0,1,1,0,0,0,0,0,0,0,0,0,0,0,0,0
,,Pacific Islander,1,1,0,1,1,0,1,1,0,0,0,0,0,0,0,0,0,0,0,0,0
,,Multiracial,2,2,0,2,2,0,2,2,0,1,1,0,0,0,0,0,0,0,0,0,0
,Georgia,All Ethnicities,224,224,0,212,212,0,183,183,0,116,116,0,19,19,0,11,11,0,31,31,0
,,White,113,113,0,107,107,0,93,93,0,56,56,0,11,11,0,2,2,0,18,18,0
,,Black,86,86,0,80,80,0,66,66,0,44,44,0,2,2,0,6,6,0,7,7,0
,,Hispanic,15,15,0,15,15,0,15,15,0,10,10,0,4,4,0,3,3,0,3,3,0
,,Asian,4,4,0,4,4,0,3,3,0,1,1,0,0,0,0,0,0,0,0,0,0
,,Multiracial,6,6,0,6,6,0,6,6,0,5,5,0,2,2,0,0,0,0,3,3,0
,Hawaii,All Ethnicities,15,15,0,14,14,0,10,10,0,0,0,0,0,0,0,0,0,0,0,0,0
,,White,6,6,0,6,6,0,3,3,0,0,0,0,0,0,0,0,0,0,0,0,0
,,Black,1,1,0,1,1,0,1,1,0,0,0,0,0,0,0,0,0,0,0,0,0
,,Unknown,1,1,0,1,1,0,1,1,0,0,0,0,0,0,0,0,0,0,0,0,0
,,Asian,1,1,0,1,1,0,1,1,0,0,0,0,0,0,0,0,0,0,0,0,0
,,,,,,,,,,,,,,,,,,,,,,,
,,,,,,,,,,,,,,,,,,,,,,,
,,Pacific Islander,5,5,0,4,4,0,3,3,0,0,0,0,0,0,0,0,0,0,0,0,0
,,Multiracial,1,1,0,1,1,0,1,1,0,0,0,0,0,0,0,0,0,0,0,0,0
,Idaho,All Ethnicities,59,59,0,57,57,0,46,46,0,26,26,0,0,0,0,3,3,0,1,1,0
,,White,49,49,0,47,47,0,38,38,0,20,20,0,0,0,0,3,3,0,0,0,0
,,Black,2,2,0,2,2,0,2,2,0,2,2,0,0,0,0,0,0,0,0,0,0
,,Hispanic,6,6,0,6,6,0,4,4,0,3,3,0,0,0,0,0,0,0,1,1,0
,,American Indian/Alaska Native,1,1,0,1,1,0,1,1,0,1,1,0,0,0,0,0,0,0,0,0,0
,,Multiracial,1,1,0,1,1,0,1,1,0,0,0,0,0,0,0,0,0,0,0,0,0
,Illinois,All Ethnicities,290,290,0,261,261,0,232,232,0,119,119,0,17,17,0,20,20,0,39,39,0
,,White,167,167,0,148,148,0,137,137,0,59,59,0,11,11,0,9,9,0,22,22,0
,,Black,78,78,0,72,72,0,60,60,0,40,40,0,5,5,0,7,7,0,14,14,0
,,Hispanic,40,40,0,36,36,0,31,31,0,19,19,0,1,1,0,3,3,0,3,3,0
,,Asian,4,4,0,4,4,0,3,3,0,0,0,0,0,0,0,1,1,0,0,0,0
,,Multiracial,1,1,0,1,1,0,1,1,0,1,1,0,0,0,0,0,0,0,0,0,0
,Indiana,All Ethnicities,159,159,0,151,151,0,133,133,0,68,68,0,27,27,0,12,12,0,24,24,0
,,White,126,126,0,120,120,0,106,106,0,49,49,0,19,19,0,9,9,0,13,13,0
,,Black,22,22,0,20,20,0,20,20,0,13,13,0,8,8,0,3,3,0,10,10,0
,,Hispanic,8,8,0,8,8,0,5,5,0,5,5,0,0,0,0,0,0,0,1,1,0
,,Unknown,1,1,0,1,1,0,1,1,0,0,0,0,0,0,0,0,0,0,0,0,0
,,Asian,2,2,0,2,2,0,1,1,0,1,1,0,0,0,0,0,0,0,0,0,0
,Iowa,All Ethnicities,77,77,0,73,73,0,63,63,0,37,37,0,7,7,0,1,1,0,16,16,0
,,White,66,66,0,63,63,0,54,54,0,31,31,0,6,6,0,1,1,0,13,13,0
,,Black,6,6,0,5,5,0,4,4,0,3,3,0,1,1,0,0,0,0,1,1,0
,,Hispanic,4,4,0,4,4,0,4,4,0,3,3,0,0,0,0,0,0,0,1,1,0
,,Asian,1,1,0,1,1,0,1,1,0,0,0,0,0,0,0,0,0,0,1,1,0
,Kansas,All Ethnicities,97,97,0,85,85,0,76,76,0,45,45,0,8,8,0,4,4,0,15,15,0
,,White,79,79,0,69,69,0,62,62,0,37,37,0,7,7,0,3,3,0,12,12,0
,,Black,6,6,0,6,6,0,6,6,0,3,3,0,0,0,0,1,1,0,1,1,0
,,Hispanic,10,10,0,8,8,0,6,6,0,4,4,0,0,0,0,0,0,0,1,1,0
,,Asian,1,1,0,1,1,0,1,1,0,1,1,0,0,0,0,0,0,0,0,0,0
,,Multiracial,1,1,0,1,1,0,1,1,0,0,0,0,1,1,0,0,0,0,1,1,0
,Kentucky,All Ethnicities,96,96,0,88,88,0,76,76,0,41,41,0,13,13,0,2,2,0,17,17,0
,,White,84,84,0,77,77,0,66,66,0,34,34,0,10,10,0,1,1,0,14,14,0
,,Black,10,10,0,9,9,0,8,8,0,5,5,0,2,2,0,1,1,0,2,2,0
,,Hispanic,1,1,0,1,1,0,1,1,0,1,1,0,0,0,0,0,0,0,0,0,0
,,Multiracial,1,1,0,1,1,0,1,1,0,1,1,0,1,1,0,0,0,0,1,1,0
,Louisiana,All Ethnicities,136,136,0,124,124,0,119,119,0,66,66,0,20,20,0,7,7,0,20,20,0
,,White,86,86,0,82,82,0,79,79,0,36,36,0,13,13,0,5,5,0,13,13,0
,,Black,44,44,0,37,37,0,35,35,0,25,25,0,6,6,0,2,2,0,7,7,0
,,Hispanic,3,3,0,2,2,0,2,2,0,3,3,0,1,1,0,0,0,0,0,0,0
,,Asian,3,3,0,3,3,0,3,3,0,2,2,0,0,0,0,0,0,0,0,0,0
,,,,,,,,,,,,,,,,,,,,,,,
,,,,,,,,,,,,,,,,,,,,,,,
,Maine,All Ethnicities,19,19,0,18,18,0,17,17,0,13,13,0,1,1,0,0,0,0,2,2,0
,,White,17,17,0,16,16,0,15,15,0,11,11,0,1,1,0,0,0,0,1,1,0
,,Hispanic,1,1,0,1,1,0,1,1,0,1,1,0,0,0,0,0,0,0,1,1,0
,,Multiracial,1,1,0,1,1,0,1,1,0,1,1,0,0,0,0,0,0,0,0,0,0
,Maryland,All Ethnicities,97,97,0,93,93,0,69,69,0,36,36,0,6,6,0,11,11,0,5,5,0
,,White,47,47,0,46,46,0,36,36,0,21,21,0,4,4,0,5,5,0,3,3,0
,,Black,43,43,0,40,40,0,28,28,0,15,15,0,2,2,0,6,6,0,2,2,0
,,Hispanic,3,3,0,3,3,0,1,1,0,0,0,0,0,0,0,0,0,0,0,0,0
,,Asian,2,2,0,2,2,0,2,2,0,0,0,0,0,0,0,0,0,0,0,0,0
,,Multiracial,2,2,0,2,2,0,2,2,0,0,0,0,0,0,0,0,0,0,0,0,0
,Massachusetts,All Ethnicities,54,54,0,51,51,0,41,41,0,20,20,0,3,3,0,3,3,0,5,5,0
,,White,41,41,0,39,39,0,32,32,0,12,12,0,1,1,0,1,1,0,2,2,0
,,Black,4,4,0,4,4,0,2,2,0,2,2,0,0,0,0,0,0,0,1,1,0
,,Hispanic,7,7,0,6,6,0,5,5,0,4,4,0,2,2,0,2,2,0,2,2,0
,,Asian,1,1,0,1,1,0,1,1,0,1,1,0,0,0,0,0,0,0,0,0,0
,,Multiracial,1,1,0,1,1,0,1,1,0,1,1,0,0,0,0,0,0,0,0,0,0
,Michigan,All Ethnicities,209,209,0,189,189,0,170,170,0,89,89,0,21,21,0,9,9,0,36,36,0
,,White,159,159,0,146,146,0,130,130,0,65,65,0,17,17,0,8,8,0,30,30,0
,,Black,40,40,0,35,35,0,33,33,0,17,17,0,4,4,0,1,1,0,5,5,0
,,Hispanic,6,6,0,4,4,0,4,4,0,5,5,0,0,0,0,0,0,0,0,0,0
,,Asian,2,2,0,2,2,0,1,1,0,1,1,0,0,0,0,0,0,0,1,1,0
,,Pacific Islander,1,1,0,1,1,0,1,1,0,1,1,0,0,0,0,0,0,0,0,0,0
,,Multiracial,1,1,0,1,1,0,1,1,0,0,0,0,0,0,0,0,0,0,0,0,0
,Minnesota,All Ethnicities,99,99,0,91,91,0,85,85,0,52,52,0,8,8,0,11,11,0,16,16,0
,,White,82,82,0,75,75,0,71,71,0,43,43,0,8,8,0,10,10,0,14,14,0
,,Black,7,7,0,7,7,0,6,6,0,2,2,0,0,0,0,0,0,0,0,0,0
,,Hispanic,4,4,0,4,4,0,4,4,0,3,3,0,0,0,0,0,0,0,0,0,0
,,Asian,4,4,0,3,3,0,2,2,0,2,2,0,0,0,0,0,0,0,1,1,0
,,American Indian/Alaska Native,1,1,0,1,1,0,1,1,0,1,1,0,0,0,0,1,1,0,0,0,0
,,Multiracial,1,1,0,1,1,0,1,1,0,1,1,0,0,0,0,0,0,0,1,1,0
,Mississippi,All Ethnicities,91,91,0,85,85,0,72,72,0,43,43,0,11,11,0,3,3,0,17,17,0
,,White,55,55,0,52,52,0,43,43,0,25,25,0,4,4,0,2,2,0,9,9,0
,,Black,32,32,0,29,29,0,25,25,0,15,15,0,6,6,0,1,1,0,7,7,0
,,Hispanic,2,2,0,2,2,0,2,2,0,1,1,0,0,0,0,0,0,0,0,0,0
,,Asian,1,1,0,1,1,0,1,1,0,1,1,0,0,0,0,0,0,0,0,0,0
,,American Indian/Alaska Native,1,1,0,1,1,0,1,1,0,1,1,0,1,1,0,0,0,0,1,1,0
,Missouri,All Ethnicities,157,157,0,137,137,0,134,134,0,83,83,0,19,19,0,14,14,0,25,25,0
,,White,116,116,0,100,100,0,101,101,0,58,58,0,16,16,0,11,11,0,19,19,0
,,Black,32,32,0,29,29,0,25,25,0,17,17,0,1,1,0,2,2,0,4,4,0
,,Hispanic,6,6,0,5,5,0,5,5,0,6,6,0,2,2,0,1,1,0,2,2,0
,,American Indian/Alaska Native,1,1,0,1,1,0,1,1,0,1,1,0,0,0,0,0,0,0,0,0,0
,,,,,,,,,,,,,,,,,,,,,,,
,,,,,,,,,,,,,,,,,,,,,,,
,,Multiracial,2,2,0,2,2,0,2,2,0,1,1,0,0,0,0,0,0,0,0,0,0
,Montana,All Ethnicities,22,22,0,20,20,0,20,20,0,14,14,0,2,2,0,0,0,0,3,3,0
,,White,20,20,0,19,19,0,18,18,0,12,12,0,2,2,0,0,0,0,3,3,0
,,Hispanic,1,1,0,1,1,0,1,1,0,1,1,0,0,0,0,0,0,0,0,0,0
,,American Indian/Alaska Native,1,1,0,0,0,0,1,1,0,1,1,0,0,0,0,0,0,0,0,0,0
,Nebraska,All Ethnicities,47,47,0,41,41,0,41,41,0,20,20,0,6,6,0,2,2,0,8,8,0
,,White,39,39,0,35,35,0,33,33,0,14,14,0,5,5,0,2,2,0,6,6,0
,,Black,2,2,0,2,2,0,2,2,0,1,1,0,0,0,0,0,0,0,0,0,0
,,Hispanic,4,4,0,3,3,0,4,4,0,4,4,0,1,1,0,0,0,0,2,2,0
,,Asian,1,1,0,0,0,0,1,1,0,0,0,0,0,0,0,0,0,0,0,0,0
,,American Indian/Alaska Native,1,1,0,1,1,0,1,1,0,1,1,0,0,0,0,0,0,0,0,0,0
,Nevada,All Ethnicities,57,57,0,54,54,0,49,49,0,28,28,0,1,1,0,1,1,0,4,4,0
,,White,39,39,0,37,37,0,34,34,0,18,18,0,1,1,0,1,1,0,1,1,0
,,Black,7,7,0,6,6,0,5,5,0,4,4,0,0,0,0,0,0,0,0,0,0
,,Hispanic,8,8,0,8,8,0,7,7,0,6,6,0,0,0,0,0,0,0,3,3,0
,,Asian,3,3,0,3,3,0,3,3,0,0,0,0,0,0,0,0,0,0,0,0,0
,New Hampshire,All Ethnicities,7,7,0,7,7,0,7,7,0,3,3,0,0,0,0,0,0,0,0,0,0
,,White,6,6,0,6,6,0,6,6,0,3,3,0,0,0,0,0,0,0,0,0,0
,,Hispanic,1,1,0,1,1,0,1,1,0,0,0,0,0,0,0,0,0,0,0,0,0
,New Jersey,All Ethnicities,166,166,0,153,153,0,118,118,0,72,72,0,7,7,0,9,9,0,14,14,0
,,White,88,88,0,83,83,0,57,57,0,31,31,0,4,4,0,4,4,0,7,7,0
,,Black,47,47,0,43,43,0,36,36,0,21,21,0,2,2,0,2,2,0,4,4,0
,,Hispanic,26,26,0,23,23,0,21,21,0,18,18,0,1,1,0,2,2,0,3,3,0
,,Asian,4,4,0,3,3,0,3,3,0,2,2,0,0,0,0,0,0,0,0,0,0
,,Multiracial,1,1,0,1,1,0,1,1,0,0,0,0,0,0,0,1,1,0,0,0,0
,New Mexico,All Ethnicities,47,47,0,43,43,0,40,40,0,19,19,0,4,4,0,4,4,0,1,1,0
,,White,18,18,0,15,15,0,14,14,0,6,6,0,2,2,0,1,1,0,0,0,0
,,Black,3,3,0,3,3,0,3,3,0,2,2,0,0,0,0,0,0,0,0,0,0
,,Hispanic,22,22,0,22,22,0,20,20,0,10,10,0,2,2,0,3,3,0,1,1,0
,,Asian,1,1,0,1,1,0,1,1,0,0,0,0,0,0,0,0,0,0,0,0,0
,,American Indian/Alaska Native,3,3,0,2,2,0,2,2,0,1,1,0,0,0,0,0,0,0,0,0,0
,New York,All Ethnicities,274,274,0,251,251,0,203,203,0,111,111,0,29,29,0,19,19,0,32,32,0
,,White,129,129,0,117,117,0,103,103,0,46,46,0,17,17,0,9,9,0,17,17,0
,,Black,61,61,0,56,56,0,38,38,0,29,29,0,9,9,0,6,6,0,4,4,0
,,Hispanic,63,63,0,59,59,0,45,45,0,27,27,0,3,3,0,2,2,0,8,8,0
,,Asian,6,6,0,6,6,0,5,5,0,2,2,0,0,0,0,0,0,0,1,1,0
,,American Indian/Alaska Native,1,1,0,1,1,0,0,0,0,1,1,0,0,0,0,0,0,0,0,0,0
,,Pacific Islander,1,1,0,1,1,0,1,1,0,0,0,0,0,0,0,1,1,0,0,0,0
,,Multiracial,13,13,0,11,11,0,11,11,0,6,6,0,0,0,0,1,1,0,2,2,0
,North Carolina,All Ethnicities,193,193,0,178,178,0,158,158,0,75,75,0,22,22,0,9,9,0,38,38,0
,,White,111,111,0,102,102,0,90,90,0,39,39,0,9,9,0,2,2,0,15,15,0
,,,,,,,,,,,,,,,,,,,,,,,
,,,,,,,,,,,,,,,,,,,,,,,
,,Black,63,63,0,59,59,0,53,53,0,28,28,0,9,9,0,6,6,0,17,17,0
,,Hispanic,18,18,0,16,16,0,14,14,0,8,8,0,4,4,0,1,1,0,6,6,0
,,Multiracial,1,1,0,1,1,0,1,1,0,0,0,0,0,0,0,0,0,0,0,0,0
,North Dakota,All Ethnicities,20,20,0,19,19,0,16,16,0,6,6,0,2,2,0,0,0,0,2,2,0
,,White,17,17,0,16,16,0,14,14,0,6,6,0,1,1,0,0,0,0,2,2,0
,,Asian,1,1,0,1,1,0,0,0,0,0,0,0,0,0,0,0,0,0,0,0,0
,,American Indian/Alaska Native,2,2,0,2,2,0,2,2,0,0,0,0,1,1,0,0,0,0,0,0,0
,Ohio,All Ethnicities,232,232,0,213,213,0,182,182,0,90,90,0,18,18,0,10,10,0,24,24,0
,,White,174,174,0,162,162,0,135,135,0,68,68,0,13,13,0,8,8,0,18,18,0
,,Black,48,48,0,41,41,0,39,39,0,19,19,0,5,5,0,2,2,0,6,6,0
,,Hispanic,6,6,0,6,6,0,6,6,0,3,3,0,0,0,0,0,0,0,0,0,0
,,Unknown,1,1,0,1,1,0,0,0,0,0,0,0,0,0,0,0,0,0,0,0,0
,,Asian,2,2,0,2,2,0,1,1,0,0,0,0,0,0,0,0,0,0,0,0,0
,,Multiracial,1,1,0,1,1,0,1,1,0,0,0,0,0,0,0,0,0,0,0,0,0
,Oklahoma,All Ethnicities,118,118,0,113,113,0,90,90,0,56,56,0,4,4,0,2,2,0,11,11,0
,,White,86,86,0,82,82,0,68,68,0,39,39,0,3,3,0,2,2,0,7,7,0
,,Black,20,20,0,20,20,0,11,11,0,12,12,0,0,0,0,0,0,0,2,2,0
,,Hispanic,7,7,0,7,7,0,6,6,0,3,3,0,1,1,0,0,0,0,1,1,0
,,Asian,2,2,0,1,1,0,2,2,0,1,1,0,0,0,0,0,0,0,1,1,0
,,American Indian/Alaska Native,3,3,0,3,3,0,3,3,0,1,1,0,0,0,0,0,0,0,0,0,0
,Oregon,All Ethnicities,75,75,0,68,68,0,62,62,0,38,38,0,2,2,0,0,0,0,2,2,0
,,White,63,63,0,57,57,0,51,51,0,30,30,0,2,2,0,0,0,0,2,2,0
,,Black,3,3,0,2,2,0,3,3,0,2,2,0,0,0,0,0,0,0,0,0,0
,,Hispanic,9,9,0,9,9,0,8,8,0,6,6,0,0,0,0,0,0,0,0,0,0
,Pennsylvania,All Ethnicities,284,283,1,274,274,0,220,219,1,107,107,0,20,20,0,21,21,0,26,26,0
,,White,197,196,1,190,190,0,149,148,1,67,67,0,12,12,0,17,17,0,17,17,0
,,Black,58,58,0,55,55,0,45,45,0,21,21,0,6,6,0,2,2,0,5,5,0
,,Hispanic,20,20,0,20,20,0,18,18,0,13,13,0,2,2,0,0,0,0,3,3,0
,,Asian,3,3,0,3,3,0,3,3,0,3,3,0,0,0,0,0,0,0,1,1,0
,,Multiracial,6,6,0,6,6,0,5,5,0,3,3,0,0,0,0,2,2,0,0,0,0
,Puerto Rico,All Ethnicities,33,33,0,33,33,0,24,24,0,4,4,0,2,2,0,0,0,0,4,4,0
,,White,2,2,0,2,2,0,1,1,0,0,0,0,0,0,0,0,0,0,1,1,0
,,Hispanic,27,27,0,27,27,0,21,21,0,3,3,0,2,2,0,0,0,0,3,3,0
,,Multiracial,4,4,0,4,4,0,2,2,0,1,1,0,0,0,0,0,0,0,0,0,0
,Rhode Island,All Ethnicities,10,10,0,10,10,0,6,6,0,3,3,0,1,1,0,1,1,0,1,1,0
,,White,7,7,0,7,7,0,3,3,0,2,2,0,1,1,0,1,1,0,1,1,0
,,Hispanic,3,3,0,3,3,0,3,3,0,1,1,0,0,0,0,0,0,0,0,0,0
,South Carolina,All Ethnicities,97,97,0,92,92,0,86,86,0,54,54,0,13,13,0,2,2,0,18,18,0
,,White,58,58,0,54,54,0,52,52,0,29,29,0,5,5,0,1,1,0,9,9,0
,,Black,34,34,0,33,33,0,29,29,0,22,22,0,8,8,0,1,1,0,9,9,0
,,Hispanic,5,5,0,5,5,0,5,5,0,3,3,0,0,0,0,0,0,0,0,0,0
,,,,,,,,,,,,,,,,,,,,,,,
,,,,,,,,,,,,,,,,,,,,,,,
,South Dakota,All Ethnicities,26,26,0,24,24,0,23,23,0,7,7,0,5,5,0,4,4,0,4,4,0
,,White,21,21,0,19,19,0,19,19,0,6,6,0,4,4,0,3,3,0,4,4,0
,,Black,1,1,0,1,1,0,1,1,0,1,1,0,0,0,0,1,1,0,0,0,0
,,American Indian/Alaska Native,3,3,0,3,3,0,2,2,0,0,0,0,1,1,0,0,0,0,0,0,0
,,Multiracial,1,1,0,1,1,0,1,1,0,0,0,0,0,0,0,0,0,0,0,0,0
,State unassigned,All Ethnicities,98,97,1,83,83,0,76,76,0,36,35,1,3,3,0,5,5,0,4,4,0
,,White,50,49,1,44,44,0,37,37,0,12,11,1,2,2,0,3,3,0,0,0,0
,,Black,20,20,0,16,16,0,18,18,0,8,8,0,1,1,0,1,1,0,0,0,0
,,Hispanic,22,22,0,17,17,0,16,16,0,14,14,0,0,0,0,1,1,0,1,1,0
,,Unknown,5,5,0,5,5,0,4,4,0,1,1,0,0,0,0,0,0,0,2,2,0
,,Asian,1,1,0,1,1,0,1,1,0,1,1,0,0,0,0,0,0,0,1,1,0
,Tennessee,All Ethnicities,179,179,0,166,166,0,153,153,0,95,95,0,30,30,0,6,6,0,37,37,0
,,White,125,125,0,115,115,0,105,105,0,66,66,0,19,19,0,1,1,0,26,26,0
,,Black,47,47,0,46,46,0,41,41,0,25,25,0,11,11,0,5,5,0,10,10,0
,,Hispanic,6,6,0,4,4,0,6,6,0,4,4,0,0,0,0,0,0,0,1,1,0
,,Multiracial,1,1,0,1,1,0,1,1,0,0,0,0,0,0,0,0,0,0,0,0,0
,Texas,All Ethnicities,729,729,0,686,686,0,573,573,0,351,351,0,28,28,0,22,22,0,69,69,0
,,White,331,331,0,310,310,0,254,254,0,145,145,0,14,14,0,10,10,0,33,33,0
,,Black,138,138,0,128,128,0,103,103,0,64,64,0,6,6,0,7,7,0,9,9,0
,,Hispanic,240,240,0,229,229,0,199,199,0,134,134,0,7,7,0,5,5,0,25,25,0
,,Unknown,2,2,0,2,2,0,2,2,0,0,0,0,0,0,0,0,0,0,0,0,0
,,Asian,13,13,0,13,13,0,11,11,0,6,6,0,0,0,0,0,0,0,1,1,0
,,Multiracial,5,5,0,4,4,0,4,4,0,2,2,0,1,1,0,0,0,0,1,1,0
,Utah,All Ethnicities,76,76,0,71,71,0,50,50,0,24,24,0,2,2,0,1,1,0,2,2,0
,,White,65,65,0,60,60,0,43,43,0,19,19,0,2,2,0,1,1,0,2,2,0
,,Black,1,1,0,1,1,0,1,1,0,1,1,0,0,0,0,0,0,0,0,0,0
,,Hispanic,5,5,0,5,5,0,3,3,0,3,3,0,0,0,0,0,0,0,0,0,0
,,Asian,2,2,0,2,2,0,2,2,0,0,0,0,0,0,0,0,0,0,0,0,0
,,Pacific Islander,3,3,0,3,3,0,1,1,0,1,1,0,0,0,0,0,0,0,0,0,0
,Vermont,All Ethnicities,7,7,0,7,7,0,6,6,0,4,4,0,1,1,0,0,0,0,1,1,0
,,White,7,7,0,7,7,0,6,6,0,4,4,0,1,1,0,0,0,0,1,1,0
,Virginia,All Ethnicities,142,142,0,134,134,0,108,108,0,57,57,0,11,11,0,7,7,0,14,14,0
,,White,86,86,0,83,83,0,68,68,0,26,26,0,8,8,0,2,2,0,8,8,0
,,Black,45,45,0,41,41,0,32,32,0,26,26,0,1,1,0,4,4,0,4,4,0
,,Hispanic,4,4,0,3,3,0,3,3,0,2,2,0,1,1,0,0,0,0,1,1,0
,,Asian,5,5,0,5,5,0,3,3,0,2,2,0,1,1,0,1,1,0,1,1,0
,,Multiracial,2,2,0,2,2,0,2,2,0,1,1,0,0,0,0,0,0,0,0,0,0
,Washington,All Ethnicities,102,102,0,94,94,0,79,79,0,46,46,0,3,3,0,2,2,0,9,9,0
,,White,75,75,0,70,70,0,57,57,0,31,31,0,2,2,0,2,2,0,4,4,0
,,Black,8,8,0,7,7,0,5,5,0,2,2,0,1,1,0,0,0,0,2,2,0
,,Hispanic,9,9,0,8,8,0,7,7,0,6,6,0,0,0,0,0,0,0,1,1,0
,,,,,,,,,,,,,,,,,,,,,,,
,,,,,,,,,,,,,,,,,,,,,,,
,,Unknown,1,1,0,0,0,0,1,1,0,1,1,0,0,0,0,0,0,0,0,0,0
,,Asian,4,4,0,4,4,0,4,4,0,2,2,0,0,0,0,0,0,0,1,1,0
,,American Indian/Alaska Native,1,1,0,1,1,0,1,1,0,0,0,0,0,0,0,0,0,0,0,0,0
,,Pacific Islander,1,1,0,1,1,0,1,1,0,1,1,0,0,0,0,0,0,0,1,1,0
,,Multiracial,3,3,0,3,3,0,3,3,0,3,3,0,0,0,0,0,0,0,0,0,0
,West Virginia,All Ethnicities,46,46,0,43,43,0,34,34,0,18,18,0,2,2,0,4,4,0,3,3,0
,,White,41,41,0,38,38,0,30,30,0,17,17,0,2,2,0,3,3,0,3,3,0
,,Black,5,5,0,5,5,0,4,4,0,1,1,0,0,0,0,1,1,0,0,0,0
,Wisconsin,All Ethnicities,111,111,0,94,94,0,91,91,0,39,39,0,8,8,0,2,2,0,9,9,0
,,White,89,89,0,76,76,0,71,71,0,26,26,0,7,7,0,1,1,0,7,7,0
,,Black,12,12,0,9,9,0,10,10,0,7,7,0,1,1,0,0,0,0,1,1,0
,,Hispanic,7,7,0,6,6,0,7,7,0,3,3,0,0,0,0,1,1,0,1,1,0
,,American Indian/Alaska Native,1,1,0,1,1,0,1,1,0,1,1,0,0,0,0,0,0,0,0,0,0
,,Multiracial,2,2,0,2,2,0,2,2,0,2,2,0,0,0,0,0,0,0,0,0,0
,Wyoming,All Ethnicities,14,14,0,13,13,0,12,12,0,6,6,0,0,0,0,0,0,0,0,0,0
,,White,14,14,0,13,13,0,12,12,0,6,6,0,0,0,0,0,0,0,0,0,0
6-10 Years,All Donor States of Residence,All Ethnicities,4413,4407,6,4306,4304,2,3686,3682,4,1709,1709,0,933,933,0,502,502,0,326,326,0
,,White,2794,2791,3,2740,2738,2,2301,2300,1,1016,1016,0,583,583,0,313,313,0,188,188,0
,,Black,848,848,0,823,823,0,724,724,0,367,367,0,190,190,0,103,103,0,72,72,0
,,Hispanic,624,622,2,603,603,0,539,537,2,282,282,0,132,132,0,74,74,0,58,58,0
,,Unknown,7,7,0,7,7,0,6,6,0,2,2,0,1,1,0,0,0,0,1,1,0
,,Asian,81,80,1,78,78,0,68,67,1,24,24,0,18,18,0,8,8,0,3,3,0
,,American Indian/Alaska Native,15,15,0,15,15,0,11,11,0,6,6,0,3,3,0,0,0,0,1,1,0
,,Pacific Islander,12,12,0,11,11,0,10,10,0,3,3,0,1,1,0,1,1,0,0,0,0
,,Multiracial,32,32,0,29,29,0,27,27,0,9,9,0,5,5,0,3,3,0,3,3,0
,Alabama,All Ethnicities,83,83,0,81,81,0,71,71,0,28,28,0,8,8,0,7,7,0,6,6,0
,,White,60,60,0,60,60,0,51,51,0,20,20,0,5,5,0,7,7,0,4,4,0
,,Black,16,16,0,14,14,0,14,14,0,5,5,0,2,2,0,0,0,0,1,1,0
,,Hispanic,4,4,0,4,4,0,4,4,0,3,3,0,0,0,0,0,0,0,1,1,0
,,Unknown,2,2,0,2,2,0,1,1,0,0,0,0,0,0,0,0,0,0,0,0,0
,,Asian,1,1,0,1,1,0,1,1,0,0,0,0,1,1,0,0,0,0,0,0,0
,Alaska,All Ethnicities,17,17,0,17,17,0,13,13,0,4,4,0,2,2,0,0,0,0,0,0,0
,,White,10,10,0,10,10,0,7,7,0,2,2,0,1,1,0,0,0,0,0,0,0
,,Hispanic,2,2,0,2,2,0,2,2,0,0,0,0,0,0,0,0,0,0,0,0,0
,,American Indian/Alaska Native,4,4,0,4,4,0,3,3,0,2,2,0,1,1,0,0,0,0,0,0,0
,,Pacific Islander,1,1,0,1,1,0,1,1,0,0,0,0,0,0,0,0,0,0,0,0,0
,Arizona,All Ethnicities,83,83,0,80,80,0,73,73,0,26,26,0,10,10,0,5,5,0,8,8,0
,,White,46,46,0,44,44,0,41,41,0,13,13,0,5,5,0,2,2,0,3,3,0
,,Black,4,4,0,4,4,0,2,2,0,0,0,0,1,1,0,0,0,0,0,0,0
,,Hispanic,27,27,0,26,26,0,25,25,0,10,10,0,4,4,0,3,3,0,5,5,0
,,Asian,1,1,0,1,1,0,1,1,0,0,0,0,0,0,0,0,0,0,0,0,0
,,,,,,,,,,,,,,,,,,,,,,,
,,,,,,,,,,,,,,,,,,,,,,,
,,American Indian/Alaska Native,3,3,0,3,3,0,2,2,0,1,1,0,0,0,0,0,0,0,0,0,0
,,Pacific Islander,1,1,0,1,1,0,1,1,0,1,1,0,0,0,0,0,0,0,0,0,0
,,Multiracial,1,1,0,1,1,0,1,1,0,1,1,0,0,0,0,0,0,0,0,0,0
,Arkansas,All Ethnicities,43,43,0,42,42,0,35,35,0,21,21,0,9,9,0,5,5,0,3,3,0
,,White,30,30,0,30,30,0,26,26,0,16,16,0,8,8,0,3,3,0,3,3,0
,,Black,12,12,0,11,11,0,8,8,0,5,5,0,1,1,0,2,2,0,0,0,0
,,Hispanic,1,1,0,1,1,0,1,1,0,0,0,0,0,0,0,0,0,0,0,0,0
,California,All Ethnicities,405,404,1,390,390,0,352,351,1,175,175,0,77,77,0,51,51,0,20,20,0
,,White,167,167,0,161,161,0,142,142,0,70,70,0,37,37,0,21,21,0,6,6,0
,,Black,53,53,0,52,52,0,48,48,0,23,23,0,6,6,0,8,8,0,2,2,0
,,Hispanic,151,150,1,144,144,0,134,133,1,68,68,0,29,29,0,18,18,0,12,12,0
,,Asian,28,28,0,28,28,0,24,24,0,11,11,0,5,5,0,3,3,0,0,0,0
,,Pacific Islander,2,2,0,1,1,0,1,1,0,1,1,0,0,0,0,1,1,0,0,0,0
,,Multiracial,4,4,0,4,4,0,3,3,0,2,2,0,0,0,0,0,0,0,0,0,0
,Colorado,All Ethnicities,51,51,0,49,49,0,39,39,0,21,21,0,13,13,0,1,1,0,3,3,0
,,White,34,34,0,32,32,0,26,26,0,15,15,0,10,10,0,1,1,0,1,1,0
,,Black,2,2,0,2,2,0,2,2,0,1,1,0,1,1,0,0,0,0,0,0,0
,,Hispanic,11,11,0,11,11,0,7,7,0,4,4,0,0,0,0,0,0,0,1,1,0
,,Asian,3,3,0,3,3,0,3,3,0,0,0,0,1,1,0,0,0,0,0,0,0
,,American Indian/Alaska Native,1,1,0,1,1,0,1,1,0,1,1,0,1,1,0,0,0,0,1,1,0
,Connecticut,All Ethnicities,39,38,1,38,37,1,29,29,0,7,7,0,7,7,0,8,8,0,4,4,0
,,White,26,25,1,26,25,1,18,18,0,5,5,0,5,5,0,6,6,0,3,3,0
,,Black,4,4,0,3,3,0,3,3,0,0,0,0,0,0,0,0,0,0,1,1,0
,,Hispanic,9,9,0,9,9,0,8,8,0,2,2,0,2,2,0,2,2,0,0,0,0
,Delaware,All Ethnicities,17,17,0,17,17,0,12,12,0,2,2,0,3,3,0,2,2,0,0,0,0
,,White,11,11,0,11,11,0,9,9,0,1,1,0,2,2,0,1,1,0,0,0,0
,,Black,3,3,0,3,3,0,1,1,0,0,0,0,0,0,0,0,0,0,0,0,0
,,Hispanic,3,3,0,3,3,0,2,2,0,1,1,0,1,1,0,1,1,0,0,0,0
,District of Columbia,All Ethnicities,9,9,0,8,8,0,9,9,0,3,3,0,2,2,0,0,0,0,3,3,0
,,Black,9,9,0,8,8,0,9,9,0,3,3,0,2,2,0,0,0,0,3,3,0
,Florida,All Ethnicities,287,286,1,276,275,1,242,242,0,117,117,0,61,61,0,42,42,0,40,40,0
,,White,151,150,1,147,146,1,127,127,0,60,60,0,31,31,0,22,22,0,21,21,0
,,Black,87,87,0,81,81,0,74,74,0,36,36,0,22,22,0,9,9,0,11,11,0
,,Hispanic,43,43,0,43,43,0,36,36,0,19,19,0,8,8,0,10,10,0,7,7,0
,,Unknown,1,1,0,1,1,0,1,1,0,1,1,0,0,0,0,0,0,0,1,1,0
,,Asian,3,3,0,2,2,0,3,3,0,1,1,0,0,0,0,1,1,0,0,0,0
,,Multiracial,2,2,0,2,2,0,1,1,0,0,0,0,0,0,0,0,0,0,0,0,0
,Georgia,All Ethnicities,156,156,0,155,155,0,124,124,0,81,81,0,18,18,0,23,23,0,16,16,0
,,White,90,90,0,90,90,0,70,70,0,46,46,0,10,10,0,12,12,0,9,9,0
,,Black,53,53,0,53,53,0,43,43,0,31,31,0,7,7,0,10,10,0,6,6,0
,,Hispanic,11,11,0,10,10,0,10,10,0,4,4,0,1,1,0,1,1,0,1,1,0
,,,,,,,,,,,,,,,,,,,,,,,
,,,,,,,,,,,,,,,,,,,,,,,
,,Asian,2,2,0,2,2,0,1,1,0,0,0,0,0,0,0,0,0,0,0,0,0
,Hawaii,All Ethnicities,16,16,0,15,15,0,12,12,0,0,0,0,0,0,0,0,0,0,0,0,0
,,White,9,9,0,8,8,0,5,5,0,0,0,0,0,0,0,0,0,0,0,0,0
,,Unknown,1,1,0,1,1,0,1,1,0,0,0,0,0,0,0,0,0,0,0,0,0
,,Pacific Islander,6,6,0,6,6,0,6,6,0,0,0,0,0,0,0,0,0,0,0,0,0
,Idaho,All Ethnicities,30,30,0,29,29,0,25,25,0,12,12,0,6,6,0,1,1,0,4,4,0
,,White,24,24,0,23,23,0,20,20,0,10,10,0,3,3,0,1,1,0,4,4,0
,,Black,2,2,0,2,2,0,2,2,0,0,0,0,1,1,0,0,0,0,0,0,0
,,Hispanic,3,3,0,3,3,0,2,2,0,2,2,0,1,1,0,0,0,0,0,0,0
,,Multiracial,1,1,0,1,1,0,1,1,0,0,0,0,1,1,0,0,0,0,0,0,0
,Illinois,All Ethnicities,177,177,0,174,174,0,151,151,0,63,63,0,56,56,0,25,25,0,9,9,0
,,White,98,98,0,98,98,0,82,82,0,36,36,0,31,31,0,11,11,0,3,3,0
,,Black,58,58,0,55,55,0,52,52,0,20,20,0,14,14,0,11,11,0,5,5,0
,,Hispanic,21,21,0,21,21,0,17,17,0,7,7,0,11,11,0,3,3,0,1,1,0
,Indiana,All Ethnicities,106,106,0,102,102,0,87,87,0,41,41,0,27,27,0,13,13,0,7,7,0
,,White,79,79,0,76,76,0,65,65,0,32,32,0,17,17,0,7,7,0,5,5,0
,,Black,17,17,0,16,16,0,14,14,0,5,5,0,4,4,0,5,5,0,1,1,0
,,Hispanic,8,8,0,8,8,0,7,7,0,4,4,0,5,5,0,1,1,0,1,1,0
,,Asian,2,2,0,2,2,0,1,1,0,0,0,0,1,1,0,0,0,0,0,0,0
,Iowa,All Ethnicities,48,48,0,48,48,0,33,33,0,16,16,0,14,14,0,5,5,0,1,1,0
,,White,41,41,0,41,41,0,28,28,0,13,13,0,10,10,0,5,5,0,1,1,0
,,Black,4,4,0,4,4,0,4,4,0,2,2,0,3,3,0,0,0,0,0,0,0
,,Hispanic,3,3,0,3,3,0,1,1,0,1,1,0,1,1,0,0,0,0,0,0,0
,Kansas,All Ethnicities,67,67,0,66,66,0,52,52,0,28,28,0,11,11,0,9,9,0,3,3,0
,,White,56,56,0,56,56,0,42,42,0,20,20,0,8,8,0,6,6,0,3,3,0
,,Black,6,6,0,6,6,0,6,6,0,4,4,0,0,0,0,2,2,0,0,0,0
,,Hispanic,5,5,0,4,4,0,4,4,0,4,4,0,3,3,0,1,1,0,0,0,0
,Kentucky,All Ethnicities,64,64,0,62,62,0,52,52,0,22,22,0,14,14,0,6,6,0,4,4,0
,,White,55,55,0,54,54,0,44,44,0,20,20,0,14,14,0,5,5,0,3,3,0
,,Black,8,8,0,7,7,0,7,7,0,1,1,0,0,0,0,0,0,0,1,1,0
,,Multiracial,1,1,0,1,1,0,1,1,0,1,1,0,0,0,0,1,1,0,0,0,0
,Louisiana,All Ethnicities,98,98,0,95,95,0,87,87,0,40,40,0,26,26,0,13,13,0,7,7,0
,,White,60,60,0,59,59,0,51,51,0,29,29,0,16,16,0,9,9,0,4,4,0
,,Black,37,37,0,35,35,0,35,35,0,11,11,0,9,9,0,4,4,0,3,3,0
,,Asian,1,1,0,1,1,0,1,1,0,0,0,0,1,1,0,0,0,0,0,0,0
,Maine,All Ethnicities,20,20,0,20,20,0,15,15,0,8,8,0,0,0,0,3,3,0,2,2,0
,,White,18,18,0,18,18,0,13,13,0,6,6,0,0,0,0,2,2,0,1,1,0
,,Black,1,1,0,1,1,0,1,1,0,1,1,0,0,0,0,1,1,0,0,0,0
,,Hispanic,1,1,0,1,1,0,1,1,0,1,1,0,0,0,0,0,0,0,1,1,0
,Maryland,All Ethnicities,63,62,1,61,61,0,50,49,1,22,22,0,20,20,0,10,10,0,2,2,0
,,White,31,31,0,30,30,0,25,25,0,10,10,0,8,8,0,4,4,0,2,2,0
,,,,,,,,,,,,,,,,,,,,,,,
,,,,,,,,,,,,,,,,,,,,,,,
,,Black,25,25,0,25,25,0,19,19,0,10,10,0,9,9,0,5,5,0,0,0,0
,,Hispanic,5,4,1,4,4,0,5,4,1,2,2,0,2,2,0,1,1,0,0,0,0
,,Multiracial,2,2,0,2,2,0,1,1,0,0,0,0,1,1,0,0,0,0,0,0,0
,Massachusetts,All Ethnicities,39,39,0,39,39,0,33,33,0,15,15,0,7,7,0,3,3,0,4,4,0
,,White,30,30,0,30,30,0,24,24,0,8,8,0,5,5,0,3,3,0,2,2,0
,,Black,1,1,0,1,1,0,1,1,0,1,1,0,0,0,0,0,0,0,0,0,0
,,Hispanic,6,6,0,6,6,0,6,6,0,5,5,0,2,2,0,0,0,0,2,2,0
,,Asian,2,2,0,2,2,0,2,2,0,1,1,0,0,0,0,0,0,0,0,0,0
,Michigan,All Ethnicities,170,170,0,166,166,0,138,138,0,67,67,0,34,34,0,28,28,0,17,17,0
,,White,120,120,0,117,117,0,93,93,0,39,39,0,17,17,0,19,19,0,10,10,0
,,Black,41,41,0,40,40,0,37,37,0,25,25,0,16,16,0,7,7,0,7,7,0
,,Hispanic,6,6,0,6,6,0,6,6,0,3,3,0,1,1,0,2,2,0,0,0,0
,,Asian,3,3,0,3,3,0,2,2,0,0,0,0,0,0,0,0,0,0,0,0,0
,Minnesota,All Ethnicities,82,82,0,82,82,0,72,72,0,31,31,0,35,35,0,14,14,0,6,6,0
,,White,71,71,0,71,71,0,62,62,0,29,29,0,30,30,0,12,12,0,6,6,0
,,Black,2,2,0,2,2,0,2,2,0,0,0,0,2,2,0,0,0,0,0,0,0
,,Hispanic,6,6,0,6,6,0,6,6,0,2,2,0,1,1,0,1,1,0,0,0,0
,,Asian,2,2,0,2,2,0,2,2,0,0,0,0,1,1,0,1,1,0,0,0,0
,,American Indian/Alaska Native,1,1,0,1,1,0,0,0,0,0,0,0,1,1,0,0,0,0,0,0,0
,Mississippi,All Ethnicities,51,51,0,51,51,0,43,43,0,24,24,0,14,14,0,6,6,0,10,10,0
,,White,32,32,0,32,32,0,26,26,0,11,11,0,6,6,0,2,2,0,6,6,0
,,Black,19,19,0,19,19,0,17,17,0,13,13,0,8,8,0,4,4,0,4,4,0
,Missouri,All Ethnicities,100,99,1,97,97,0,88,87,1,39,39,0,14,14,0,17,17,0,11,11,0
,,White,82,81,1,79,79,0,72,71,1,30,30,0,11,11,0,14,14,0,8,8,0
,,Black,15,15,0,15,15,0,14,14,0,9,9,0,3,3,0,3,3,0,3,3,0
,,Hispanic,2,2,0,2,2,0,1,1,0,0,0,0,0,0,0,0,0,0,0,0,0
,,Asian,1,1,0,1,1,0,1,1,0,0,0,0,0,0,0,0,0,0,0,0,0
,Montana,All Ethnicities,23,23,0,23,23,0,20,20,0,11,11,0,3,3,0,2,2,0,1,1,0
,,White,21,21,0,21,21,0,19,19,0,10,10,0,3,3,0,2,2,0,1,1,0
,,American Indian/Alaska Native,2,2,0,2,2,0,1,1,0,1,1,0,0,0,0,0,0,0,0,0,0
,Nebraska,All Ethnicities,24,24,0,23,23,0,20,20,0,6,6,0,12,12,0,2,2,0,6,6,0
,,White,21,21,0,21,21,0,17,17,0,5,5,0,10,10,0,2,2,0,4,4,0
,,Hispanic,3,3,0,2,2,0,3,3,0,1,1,0,2,2,0,0,0,0,2,2,0
,Nevada,All Ethnicities,32,32,0,31,31,0,27,27,0,14,14,0,5,5,0,0,0,0,5,5,0
,,White,19,19,0,19,19,0,16,16,0,6,6,0,1,1,0,0,0,0,3,3,0
,,Black,4,4,0,4,4,0,3,3,0,3,3,0,1,1,0,0,0,0,0,0,0
,,Hispanic,6,6,0,6,6,0,5,5,0,4,4,0,2,2,0,0,0,0,2,2,0
,,Asian,3,3,0,2,2,0,3,3,0,1,1,0,1,1,0,0,0,0,0,0,0
,New Hampshire,All Ethnicities,7,7,0,7,7,0,5,5,0,1,1,0,1,1,0,0,0,0,0,0,0
,,White,7,7,0,7,7,0,5,5,0,1,1,0,1,1,0,0,0,0,0,0,0
,New Jersey,All Ethnicities,97,97,0,92,92,0,71,71,0,30,30,0,20,20,0,8,8,0,4,4,0
,,,,,,,,,,,,,,,,,,,,,,,
,,,,,,,,,,,,,,,,,,,,,,,
,,White,55,55,0,51,51,0,38,38,0,13,13,0,12,12,0,4,4,0,0,0,0
,,Black,20,20,0,19,19,0,18,18,0,8,8,0,5,5,0,1,1,0,4,4,0
,,Hispanic,16,16,0,16,16,0,13,13,0,8,8,0,2,2,0,2,2,0,0,0,0
,,Asian,6,6,0,6,6,0,2,2,0,1,1,0,1,1,0,1,1,0,0,0,0
,New Mexico,All Ethnicities,32,32,0,31,31,0,31,31,0,13,13,0,2,2,0,2,2,0,2,2,0
,,White,14,14,0,13,13,0,14,14,0,2,2,0,2,2,0,1,1,0,1,1,0
,,Black,2,2,0,2,2,0,2,2,0,1,1,0,0,0,0,0,0,0,0,0,0
,,Hispanic,15,15,0,15,15,0,14,14,0,9,9,0,0,0,0,1,1,0,0,0,0
,,Multiracial,1,1,0,1,1,0,1,1,0,1,1,0,0,0,0,0,0,0,1,1,0
,New York,All Ethnicities,185,184,1,177,177,0,141,140,1,75,75,0,28,28,0,13,13,0,11,11,0
,,White,100,100,0,98,98,0,71,71,0,39,39,0,16,16,0,6,6,0,4,4,0
,,Black,46,46,0,46,46,0,35,35,0,19,19,0,4,4,0,2,2,0,2,2,0
,,Hispanic,36,36,0,32,32,0,32,32,0,16,16,0,7,7,0,4,4,0,5,5,0
,,Asian,2,1,1,1,1,0,2,1,1,0,0,0,1,1,0,0,0,0,0,0,0
,,Multiracial,1,1,0,0,0,0,1,1,0,1,1,0,0,0,0,1,1,0,0,0,0
,North Carolina,All Ethnicities,132,132,0,130,130,0,119,119,0,51,51,0,41,41,0,20,20,0,11,11,0
,,White,82,82,0,80,80,0,74,74,0,27,27,0,24,24,0,11,11,0,7,7,0
,,Black,36,36,0,36,36,0,32,32,0,17,17,0,14,14,0,7,7,0,1,1,0
,,Hispanic,11,11,0,11,11,0,11,11,0,7,7,0,2,2,0,1,1,0,2,2,0
,,Asian,1,1,0,1,1,0,1,1,0,0,0,0,1,1,0,0,0,0,1,1,0
,,American Indian/Alaska Native,1,1,0,1,1,0,1,1,0,0,0,0,0,0,0,0,0,0,0,0,0
,,Multiracial,1,1,0,1,1,0,0,0,0,0,0,0,0,0,0,1,1,0,0,0,0
,North Dakota,All Ethnicities,14,14,0,14,14,0,12,12,0,6,6,0,3,3,0,1,1,0,5,5,0
,,White,14,14,0,14,14,0,12,12,0,6,6,0,3,3,0,1,1,0,5,5,0
,Ohio,All Ethnicities,157,157,0,154,154,0,125,125,0,53,53,0,51,51,0,19,19,0,9,9,0
,,White,115,115,0,115,115,0,89,89,0,38,38,0,40,40,0,16,16,0,7,7,0
,,Black,34,34,0,32,32,0,30,30,0,11,11,0,7,7,0,1,1,0,1,1,0
,,Hispanic,4,4,0,3,3,0,3,3,0,3,3,0,3,3,0,2,2,0,1,1,0
,,Asian,3,3,0,3,3,0,2,2,0,1,1,0,1,1,0,0,0,0,0,0,0
,,Multiracial,1,1,0,1,1,0,1,1,0,0,0,0,0,0,0,0,0,0,0,0,0
,Oklahoma,All Ethnicities,71,71,0,68,68,0,55,55,0,29,29,0,5,5,0,4,4,0,6,6,0
,,White,60,60,0,57,57,0,47,47,0,27,27,0,3,3,0,4,4,0,5,5,0
,,Black,6,6,0,6,6,0,4,4,0,1,1,0,2,2,0,0,0,0,1,1,0
,,Hispanic,3,3,0,3,3,0,2,2,0,0,0,0,0,0,0,0,0,0,0,0,0
,,Asian,1,1,0,1,1,0,1,1,0,0,0,0,0,0,0,0,0,0,0,0,0
,,American Indian/Alaska Native,1,1,0,1,1,0,1,1,0,1,1,0,0,0,0,0,0,0,0,0,0
,Oregon,All Ethnicities,42,42,0,41,41,0,36,36,0,15,15,0,5,5,0,2,2,0,2,2,0
,,White,37,37,0,36,36,0,33,33,0,13,13,0,4,4,0,2,2,0,2,2,0
,,Black,1,1,0,1,1,0,0,0,0,0,0,0,0,0,0,0,0,0,0,0,0
,,Hispanic,4,4,0,4,4,0,3,3,0,2,2,0,1,1,0,0,0,0,0,0,0
,Pennsylvania,All Ethnicities,206,206,0,203,203,0,170,170,0,79,79,0,64,64,0,27,27,0,13,13,0
,,,,,,,,,,,,,,,,,,,,,,,
,,,,,,,,,,,,,,,,,,,,,,,
,,White,150,150,0,148,148,0,121,121,0,50,50,0,43,43,0,20,20,0,11,11,0
,,Black,38,38,0,37,37,0,33,33,0,18,18,0,13,13,0,4,4,0,0,0,0
,,Hispanic,13,13,0,13,13,0,12,12,0,9,9,0,6,6,0,2,2,0,2,2,0
,,Asian,4,4,0,4,4,0,3,3,0,2,2,0,2,2,0,1,1,0,0,0,0
,,Multiracial,1,1,0,1,1,0,1,1,0,0,0,0,0,0,0,0,0,0,0,0,0
,Puerto Rico,All Ethnicities,25,25,0,23,23,0,21,21,0,6,6,0,5,5,0,0,0,0,3,3,0
,,Hispanic,16,16,0,15,15,0,12,12,0,5,5,0,2,2,0,0,0,0,1,1,0
,,Multiracial,9,9,0,8,8,0,9,9,0,1,1,0,3,3,0,0,0,0,2,2,0
,Rhode Island,All Ethnicities,12,12,0,11,11,0,9,9,0,5,5,0,2,2,0,2,2,0,1,1,0
,,White,8,8,0,8,8,0,7,7,0,4,4,0,2,2,0,2,2,0,0,0,0
,,Black,1,1,0,1,1,0,0,0,0,0,0,0,0,0,0,0,0,0,0,0,0
,,Hispanic,3,3,0,2,2,0,2,2,0,1,1,0,0,0,0,0,0,0,1,1,0
,South Carolina,All Ethnicities,75,75,0,74,74,0,66,66,0,36,36,0,22,22,0,8,8,0,5,5,0
,,White,47,47,0,46,46,0,42,42,0,19,19,0,13,13,0,6,6,0,2,2,0
,,Black,24,24,0,24,24,0,20,20,0,14,14,0,8,8,0,2,2,0,3,3,0
,,Hispanic,3,3,0,3,3,0,3,3,0,2,2,0,1,1,0,0,0,0,0,0,0
,,Asian,1,1,0,1,1,0,1,1,0,1,1,0,0,0,0,0,0,0,0,0,0
,South Dakota,All Ethnicities,20,20,0,20,20,0,20,20,0,10,10,0,7,7,0,5,5,0,4,4,0
,,White,16,16,0,16,16,0,16,16,0,7,7,0,6,6,0,4,4,0,3,3,0
,,Black,3,3,0,3,3,0,3,3,0,3,3,0,1,1,0,1,1,0,1,1,0
,,American Indian/Alaska Native,1,1,0,1,1,0,1,1,0,0,0,0,0,0,0,0,0,0,0,0,0
,State unassigned,All Ethnicities,77,77,0,76,76,0,67,67,0,30,30,0,13,13,0,10,10,0,4,4,0
,,White,38,38,0,38,38,0,34,34,0,10,10,0,5,5,0,6,6,0,1,1,0
,,Black,9,9,0,9,9,0,6,6,0,3,3,0,1,1,0,0,0,0,0,0,0
,,Hispanic,24,24,0,23,23,0,21,21,0,14,14,0,6,6,0,4,4,0,2,2,0
,,Unknown,2,2,0,2,2,0,2,2,0,1,1,0,1,1,0,0,0,0,0,0,0
,,Asian,4,4,0,4,4,0,4,4,0,2,2,0,0,0,0,0,0,0,1,1,0
,Tennessee,All Ethnicities,96,96,0,95,95,0,77,77,0,37,37,0,25,25,0,9,9,0,8,8,0
,,White,70,70,0,69,69,0,56,56,0,24,24,0,16,16,0,6,6,0,6,6,0
,,Black,22,22,0,22,22,0,17,17,0,10,10,0,7,7,0,2,2,0,0,0,0
,,Hispanic,2,2,0,2,2,0,2,2,0,2,2,0,2,2,0,1,1,0,1,1,0
,,Asian,1,1,0,1,1,0,1,1,0,1,1,0,0,0,0,0,0,0,1,1,0
,,Multiracial,1,1,0,1,1,0,1,1,0,0,0,0,0,0,0,0,0,0,0,0,0
,Texas,All Ethnicities,399,399,0,394,394,0,339,339,0,153,153,0,50,50,0,36,36,0,19,19,0
,,White,197,197,0,194,194,0,168,168,0,70,70,0,23,23,0,19,19,0,7,7,0
,,Black,71,71,0,71,71,0,60,60,0,32,32,0,7,7,0,4,4,0,5,5,0
,,Hispanic,121,121,0,120,120,0,101,101,0,47,47,0,18,18,0,13,13,0,7,7,0
,,Asian,5,5,0,5,5,0,5,5,0,1,1,0,1,1,0,0,0,0,0,0,0
,,Pacific Islander,1,1,0,1,1,0,1,1,0,1,1,0,1,1,0,0,0,0,0,0,0
,,Multiracial,4,4,0,3,3,0,4,4,0,2,2,0,0,0,0,0,0,0,0,0,0
,Utah,All Ethnicities,51,51,0,51,51,0,48,48,0,20,20,0,9,9,0,0,0,0,3,3,0
,,,,,,,,,,,,,,,,,,,,,,,
,,,,,,,,,,,,,,,,,,,,,,,
,,White,46,46,0,46,46,0,44,44,0,19,19,0,8,8,0,0,0,0,3,3,0
,,Hispanic,4,4,0,4,4,0,3,3,0,1,1,0,1,1,0,0,0,0,0,0,0
,,Multiracial,1,1,0,1,1,0,1,1,0,0,0,0,0,0,0,0,0,0,0,0,0
,Vermont,All Ethnicities,10,10,0,10,10,0,10,10,0,4,4,0,1,1,0,1,1,0,0,0,0
,,White,10,10,0,10,10,0,10,10,0,4,4,0,1,1,0,1,1,0,0,0,0
,Virginia,All Ethnicities,93,93,0,93,93,0,77,77,0,37,37,0,17,17,0,12,12,0,8,8,0
,,White,55,55,0,55,55,0,44,44,0,19,19,0,10,10,0,7,7,0,3,3,0
,,Black,34,34,0,34,34,0,30,30,0,15,15,0,5,5,0,4,4,0,5,5,0
,,Hispanic,2,2,0,2,2,0,2,2,0,2,2,0,2,2,0,0,0,0,0,0,0
,,Asian,1,1,0,1,1,0,1,1,0,1,1,0,0,0,0,1,1,0,0,0,0
,,Pacific Islander,1,1,0,1,1,0,0,0,0,0,0,0,0,0,0,0,0,0,0,0,0
,Washington,All Ethnicities,67,67,0,63,63,0,56,56,0,22,22,0,7,7,0,4,4,0,1,1,0
,,White,57,57,0,53,53,0,47,47,0,17,17,0,7,7,0,4,4,0,1,1,0
,,Black,3,3,0,3,3,0,3,3,0,1,1,0,0,0,0,0,0,0,0,0,0
,,Hispanic,4,4,0,4,4,0,4,4,0,4,4,0,0,0,0,0,0,0,0,0,0
,,Unknown,1,1,0,1,1,0,1,1,0,0,0,0,0,0,0,0,0,0,0,0,0
,,American Indian/Alaska Native,1,1,0,1,1,0,1,1,0,0,0,0,0,0,0,0,0,0,0,0,0
,,Multiracial,1,1,0,1,1,0,0,0,0,0,0,0,0,0,0,0,0,0,0,0,0
,West Virginia,All Ethnicities,40,40,0,40,40,0,35,35,0,12,12,0,2,2,0,5,5,0,2,2,0
,,White,38,38,0,38,38,0,33,33,0,11,11,0,1,1,0,3,3,0,2,2,0
,,Black,2,2,0,2,2,0,2,2,0,1,1,0,1,1,0,2,2,0,0,0,0
,Wisconsin,All Ethnicities,99,99,0,96,96,0,89,89,0,40,40,0,44,44,0,13,13,0,3,3,0
,,White,81,81,0,79,79,0,73,73,0,33,33,0,38,38,0,11,11,0,2,2,0
,,Black,13,13,0,12,12,0,11,11,0,4,4,0,3,3,0,2,2,0,1,1,0
,,Hispanic,5,5,0,5,5,0,5,5,0,3,3,0,3,3,0,0,0,0,0,0,0
,Wyoming,All Ethnicities,6,6,0,6,6,0,3,3,0,1,1,0,1,1,0,0,0,0,0,0,0
,,White,5,5,0,5,5,0,2,2,0,1,1,0,1,1,0,0,0,0,0,0,0
,,Hispanic,1,1,0,1,1,0,1,1,0,0,0,0,0,0,0,0,0,0,0,0,0
11-17 Years,All Donor States of Residence,All Ethnicities,16574,16509,65,16200,16155,45,14492,14472,20,9563,9563,0,7709,7709,0,4568,4568,0,440,440,0
,,White,11472,11432,40,11248,11218,30,10023,10013,10,6551,6551,0,5389,5389,0,3037,3037,0,294,294,0
,,Black,2428,2422,6,2360,2356,4,2130,2128,2,1433,1433,0,1142,1142,0,774,774,0,80,80,0
,,Hispanic,2194,2178,16,2127,2119,8,1919,1911,8,1332,1332,0,956,956,0,629,629,0,54,54,0
,,Unknown,30,29,1,30,29,1,21,21,0,14,14,0,9,9,0,6,6,0,0,0,0
,,Asian,233,232,1,225,224,1,200,200,0,115,115,0,109,109,0,58,58,0,7,7,0
,,American Indian/Alaska Native,103,102,1,99,98,1,92,92,0,57,57,0,49,49,0,28,28,0,2,2,0
,,Pacific Islander,26,26,0,24,24,0,22,22,0,7,7,0,14,14,0,6,6,0,0,0,0
,,Multiracial,88,88,0,87,87,0,85,85,0,54,54,0,41,41,0,30,30,0,3,3,0
,Alabama,All Ethnicities,328,328,0,321,321,0,268,268,0,180,180,0,131,131,0,85,85,0,5,5,0
,,White,246,246,0,241,241,0,198,198,0,137,137,0,101,101,0,63,63,0,3,3,0
,,Black,75,75,0,73,73,0,64,64,0,39,39,0,27,27,0,21,21,0,1,1,0
,,Hispanic,4,4,0,4,4,0,3,3,0,3,3,0,1,1,0,1,1,0,1,1,0
,,,,,,,,,,,,,,,,,,,,,,,
,,,,,,,,,,,,,,,,,,,,,,,
,,Asian,1,1,0,1,1,0,1,1,0,0,0,0,1,1,0,0,0,0,0,0,0
,,American Indian/Alaska Native,1,1,0,1,1,0,1,1,0,1,1,0,1,1,0,0,0,0,0,0,0
,,Multiracial,1,1,0,1,1,0,1,1,0,0,0,0,0,0,0,0,0,0,0,0,0
,Alaska,All Ethnicities,58,58,0,57,57,0,49,49,0,27,27,0,31,31,0,16,16,0,0,0,0
,,White,40,40,0,39,39,0,34,34,0,20,20,0,21,21,0,11,11,0,0,0,0
,,Black,2,2,0,2,2,0,1,1,0,0,0,0,0,0,0,0,0,0,0,0,0
,,Hispanic,1,1,0,1,1,0,1,1,0,0,0,0,0,0,0,0,0,0,0,0,0
,,Asian,2,2,0,2,2,0,1,1,0,2,2,0,1,1,0,0,0,0,0,0,0
,,American Indian/Alaska Native,13,13,0,13,13,0,12,12,0,5,5,0,9,9,0,5,5,0,0,0,0
,Arizona,All Ethnicities,303,303,0,298,298,0,271,271,0,158,158,0,120,120,0,80,80,0,5,5,0
,,White,189,189,0,186,186,0,167,167,0,106,106,0,70,70,0,47,47,0,3,3,0
,,Black,17,17,0,15,15,0,16,16,0,7,7,0,2,2,0,3,3,0,0,0,0
,,Hispanic,81,81,0,81,81,0,75,75,0,37,37,0,40,40,0,23,23,0,1,1,0
,,Unknown,1,1,0,1,1,0,0,0,0,0,0,0,0,0,0,0,0,0,0,0,0
,,Asian,5,5,0,5,5,0,4,4,0,3,3,0,2,2,0,3,3,0,0,0,0
,,American Indian/Alaska Native,7,7,0,7,7,0,7,7,0,4,4,0,5,5,0,4,4,0,1,1,0
,,Pacific Islander,1,1,0,1,1,0,0,0,0,0,0,0,0,0,0,0,0,0,0,0,0
,,Multiracial,2,2,0,2,2,0,2,2,0,1,1,0,1,1,0,0,0,0,0,0,0
,Arkansas,All Ethnicities,177,177,0,172,172,0,153,153,0,108,108,0,59,59,0,50,50,0,6,6,0
,,White,141,141,0,139,139,0,122,122,0,89,89,0,49,49,0,42,42,0,5,5,0
,,Black,32,32,0,29,29,0,27,27,0,17,17,0,9,9,0,7,7,0,1,1,0
,,Hispanic,3,3,0,3,3,0,3,3,0,2,2,0,1,1,0,0,0,0,0,0,0
,,American Indian/Alaska Native,1,1,0,1,1,0,1,1,0,0,0,0,0,0,0,1,1,0,0,0,0
,California,All Ethnicities,1498,1494,4,1456,1453,3,1348,1347,1,946,946,0,692,692,0,427,427,0,22,22,0
,,White,680,679,1,664,663,1,614,614,0,406,406,0,310,310,0,170,170,0,8,8,0
,,Black,136,136,0,132,132,0,122,122,0,90,90,0,58,58,0,45,45,0,3,3,0
,,Hispanic,584,581,3,565,563,2,523,522,1,395,395,0,283,283,0,187,187,0,9,9,0
,,Unknown,2,2,0,2,2,0,2,2,0,1,1,0,1,1,0,0,0,0,0,0,0
,,Asian,66,66,0,64,64,0,59,59,0,38,38,0,29,29,0,14,14,0,2,2,0
,,American Indian/Alaska Native,7,7,0,7,7,0,5,5,0,4,4,0,3,3,0,3,3,0,0,0,0
,,Pacific Islander,5,5,0,4,4,0,5,5,0,3,3,0,2,2,0,2,2,0,0,0,0
,,Multiracial,18,18,0,18,18,0,18,18,0,9,9,0,6,6,0,6,6,0,0,0,0
,Colorado,All Ethnicities,291,291,0,284,284,0,268,268,0,185,185,0,156,156,0,76,76,0,6,6,0
,,White,223,223,0,218,218,0,208,208,0,142,142,0,126,126,0,61,61,0,6,6,0
,,Black,13,13,0,12,12,0,11,11,0,7,7,0,6,6,0,2,2,0,0,0,0
,,Hispanic,47,47,0,46,46,0,41,41,0,33,33,0,23,23,0,12,12,0,0,0,0
,,Asian,5,5,0,5,5,0,5,5,0,1,1,0,1,1,0,0,0,0,0,0,0
,,American Indian/Alaska Native,3,3,0,3,3,0,3,3,0,2,2,0,0,0,0,1,1,0,0,0,0
,Connecticut,All Ethnicities,130,130,0,124,124,0,104,104,0,77,77,0,50,50,0,21,21,0,1,1,0
,,White,96,96,0,91,91,0,73,73,0,53,53,0,31,31,0,9,9,0,1,1,0
,,Black,13,13,0,13,13,0,12,12,0,9,9,0,8,8,0,4,4,0,0,0,0
,,,,,,,,,,,,,,,,,,,,,,,
,,,,,,,,,,,,,,,,,,,,,,,
,,Hispanic,17,17,0,16,16,0,17,17,0,11,11,0,8,8,0,7,7,0,0,0,0
,,Unknown,2,2,0,2,2,0,0,0,0,2,2,0,1,1,0,0,0,0,0,0,0
,,Asian,1,1,0,1,1,0,1,1,0,1,1,0,1,1,0,0,0,0,0,0,0
,,American Indian/Alaska Native,1,1,0,1,1,0,1,1,0,1,1,0,1,1,0,1,1,0,0,0,0
,Delaware,All Ethnicities,53,53,0,51,51,0,46,46,0,22,22,0,23,23,0,11,11,0,1,1,0
,,White,45,45,0,43,43,0,40,40,0,20,20,0,20,20,0,10,10,0,1,1,0
,,Black,6,6,0,6,6,0,4,4,0,1,1,0,2,2,0,0,0,0,0,0,0
,,Hispanic,2,2,0,2,2,0,2,2,0,1,1,0,1,1,0,1,1,0,0,0,0
,District of Columbia,All Ethnicities,33,32,1,32,31,1,29,29,0,22,22,0,24,24,0,9,9,0,0,0,0
,,White,1,1,0,1,1,0,1,1,0,1,1,0,0,0,0,0,0,0,0,0,0
,,Black,32,31,1,31,30,1,28,28,0,21,21,0,24,24,0,9,9,0,0,0,0
,Florida,All Ethnicities,955,955,0,935,935,0,826,826,0,513,513,0,422,422,0,252,252,0,63,63,0
,,White,630,630,0,616,616,0,546,546,0,348,348,0,266,266,0,157,157,0,32,32,0
,,Black,174,174,0,171,171,0,149,149,0,87,87,0,80,80,0,52,52,0,12,12,0
,,Hispanic,140,140,0,137,137,0,121,121,0,76,76,0,73,73,0,40,40,0,17,17,0
,,Unknown,1,1,0,1,1,0,1,1,0,0,0,0,1,1,0,0,0,0,0,0,0
,,Asian,3,3,0,3,3,0,3,3,0,1,1,0,1,1,0,0,0,0,0,0,0
,,American Indian/Alaska Native,1,1,0,1,1,0,1,1,0,0,0,0,0,0,0,0,0,0,0,0,0
,,Multiracial,6,6,0,6,6,0,5,5,0,1,1,0,1,1,0,3,3,0,2,2,0
,Georgia,All Ethnicities,498,497,1,489,489,0,439,438,1,310,310,0,197,197,0,133,133,0,12,12,0
,,White,340,339,1,335,335,0,301,300,1,214,214,0,135,135,0,85,85,0,9,9,0
,,Black,128,128,0,125,125,0,110,110,0,76,76,0,49,49,0,36,36,0,3,3,0
,,Hispanic,26,26,0,25,25,0,24,24,0,18,18,0,11,11,0,10,10,0,0,0,0
,,Asian,3,3,0,3,3,0,3,3,0,1,1,0,2,2,0,2,2,0,0,0,0
,,Multiracial,1,1,0,1,1,0,1,1,0,1,1,0,0,0,0,0,0,0,0,0,0
,Hawaii,All Ethnicities,35,35,0,34,34,0,32,32,0,9,9,0,13,13,0,2,2,0,0,0,0
,,White,10,10,0,10,10,0,9,9,0,5,5,0,3,3,0,1,1,0,0,0,0
,,Hispanic,1,1,0,1,1,0,1,1,0,0,0,0,1,1,0,0,0,0,0,0,0
,,Asian,9,9,0,9,9,0,9,9,0,2,2,0,3,3,0,1,1,0,0,0,0
,,Pacific Islander,11,11,0,10,10,0,9,9,0,1,1,0,5,5,0,0,0,0,0,0,0
,,Multiracial,4,4,0,4,4,0,4,4,0,1,1,0,1,1,0,0,0,0,0,0,0
,Idaho,All Ethnicities,111,111,0,108,108,0,100,100,0,72,72,0,55,55,0,24,24,0,4,4,0
,,White,102,102,0,100,100,0,94,94,0,66,66,0,50,50,0,22,22,0,2,2,0
,,Black,1,1,0,1,1,0,1,1,0,0,0,0,1,1,0,0,0,0,1,1,0
,,Hispanic,7,7,0,6,6,0,5,5,0,5,5,0,4,4,0,2,2,0,1,1,0
,,American Indian/Alaska Native,1,1,0,1,1,0,0,0,0,1,1,0,0,0,0,0,0,0,0,0,0
,Illinois,All Ethnicities,725,717,8,710,704,6,625,623,2,380,380,0,386,386,0,236,236,0,14,14,0
,,White,428,421,7,419,413,6,358,357,1,217,217,0,217,217,0,127,127,0,11,11,0
,,Black,192,192,0,189,189,0,172,172,0,109,109,0,113,113,0,78,78,0,2,2,0
,,Hispanic,95,94,1,92,92,0,86,85,1,49,49,0,52,52,0,28,28,0,1,1,0
,,Asian,9,9,0,9,9,0,8,8,0,4,4,0,4,4,0,3,3,0,0,0,0
,,,,,,,,,,,,,,,,,,,,,,,
,,,,,,,,,,,,,,,,,,,,,,,
,,Multiracial,1,1,0,1,1,0,1,1,0,1,1,0,0,0,0,0,0,0,0,0,0
,Indiana,All Ethnicities,415,412,3,407,405,2,380,379,1,272,272,0,234,234,0,121,121,0,39,39,0
,,White,336,334,2,332,331,1,308,307,1,220,220,0,182,182,0,101,101,0,34,34,0
,,Black,60,59,1,59,58,1,53,53,0,39,39,0,37,37,0,15,15,0,4,4,0
,,Hispanic,16,16,0,14,14,0,16,16,0,12,12,0,13,13,0,5,5,0,1,1,0
,,Asian,3,3,0,2,2,0,3,3,0,1,1,0,2,2,0,0,0,0,0,0,0
,Iowa,All Ethnicities,206,204,2,199,198,1,188,187,1,106,106,0,113,113,0,57,57,0,3,3,0
,,White,188,187,1,185,184,1,174,174,0,97,97,0,107,107,0,50,50,0,2,2,0
,,Black,9,9,0,8,8,0,8,8,0,4,4,0,1,1,0,4,4,0,1,1,0
,,Hispanic,6,5,1,4,4,0,5,4,1,4,4,0,3,3,0,2,2,0,0,0,0
,,Asian,1,1,0,1,1,0,0,0,0,0,0,0,1,1,0,0,0,0,0,0,0
,,American Indian/Alaska Native,2,2,0,1,1,0,1,1,0,1,1,0,1,1,0,1,1,0,0,0,0
,Kansas,All Ethnicities,257,257,0,255,255,0,233,233,0,137,137,0,133,133,0,77,77,0,6,6,0
,,White,209,209,0,208,208,0,190,190,0,110,110,0,109,109,0,60,60,0,5,5,0
,,Black,17,17,0,17,17,0,15,15,0,8,8,0,7,7,0,4,4,0,1,1,0
,,Hispanic,26,26,0,25,25,0,23,23,0,16,16,0,14,14,0,11,11,0,0,0,0
,,Unknown,1,1,0,1,1,0,1,1,0,0,0,0,0,0,0,0,0,0,0,0,0
,,Asian,2,2,0,2,2,0,2,2,0,1,1,0,1,1,0,1,1,0,0,0,0
,,Pacific Islander,1,1,0,1,1,0,1,1,0,1,1,0,1,1,0,0,0,0,0,0,0
,,Multiracial,1,1,0,1,1,0,1,1,0,1,1,0,1,1,0,1,1,0,0,0,0
,Kentucky,All Ethnicities,239,237,2,234,233,1,214,213,1,135,135,0,103,103,0,84,84,0,4,4,0
,,White,211,209,2,206,205,1,188,187,1,120,120,0,88,88,0,76,76,0,4,4,0
,,Black,19,19,0,19,19,0,17,17,0,8,8,0,11,11,0,4,4,0,0,0,0
,,Hispanic,8,8,0,8,8,0,8,8,0,6,6,0,4,4,0,4,4,0,0,0,0
,,Asian,1,1,0,1,1,0,1,1,0,1,1,0,0,0,0,0,0,0,0,0,0
,Louisiana,All Ethnicities,384,384,0,376,376,0,356,356,0,246,246,0,210,210,0,125,125,0,16,16,0
,,White,261,261,0,257,257,0,242,242,0,169,169,0,146,146,0,84,84,0,12,12,0
,,Black,115,115,0,111,111,0,107,107,0,71,71,0,59,59,0,40,40,0,3,3,0
,,Hispanic,5,5,0,5,5,0,5,5,0,4,4,0,3,3,0,1,1,0,1,1,0
,,Asian,2,2,0,2,2,0,1,1,0,1,1,0,1,1,0,0,0,0,0,0,0
,,American Indian/Alaska Native,1,1,0,1,1,0,1,1,0,1,1,0,1,1,0,0,0,0,0,0,0
,Maine,All Ethnicities,69,69,0,67,67,0,61,61,0,37,37,0,33,33,0,7,7,0,1,1,0
,,White,66,66,0,64,64,0,58,58,0,36,36,0,30,30,0,7,7,0,1,1,0
,,Black,3,3,0,3,3,0,3,3,0,1,1,0,3,3,0,0,0,0,0,0,0
,Maryland,All Ethnicities,268,264,4,260,258,2,234,232,2,152,152,0,157,157,0,94,94,0,10,10,0
,,White,165,164,1,161,160,1,145,145,0,90,90,0,93,93,0,55,55,0,4,4,0
,,Black,84,82,2,81,80,1,72,71,1,51,51,0,51,51,0,30,30,0,3,3,0
,,Hispanic,11,10,1,10,10,0,10,9,1,8,8,0,9,9,0,6,6,0,3,3,0
,,Asian,8,8,0,8,8,0,7,7,0,3,3,0,4,4,0,3,3,0,0,0,0
,Massachusetts,All Ethnicities,213,213,0,208,208,0,167,167,0,113,113,0,81,81,0,42,42,0,3,3,0
,,White,162,162,0,158,158,0,125,125,0,88,88,0,59,59,0,30,30,0,3,3,0
,,,,,,,,,,,,,,,,,,,,,,,
,,,,,,,,,,,,,,,,,,,,,,,
,,Black,19,19,0,19,19,0,17,17,0,7,7,0,6,6,0,3,3,0,0,0,0
,,Hispanic,27,27,0,27,27,0,20,20,0,16,16,0,14,14,0,7,7,0,0,0,0
,,Unknown,1,1,0,1,1,0,1,1,0,1,1,0,0,0,0,0,0,0,0,0,0
,,Asian,3,3,0,2,2,0,3,3,0,0,0,0,2,2,0,2,2,0,0,0,0
,,Multiracial,1,1,0,1,1,0,1,1,0,1,1,0,0,0,0,0,0,0,0,0,0
,Michigan,All Ethnicities,621,619,2,605,605,0,516,514,2,322,322,0,264,264,0,167,167,0,21,21,0
,,White,485,484,1,476,476,0,401,400,1,242,242,0,200,200,0,118,118,0,11,11,0
,,Black,109,109,0,104,104,0,95,95,0,66,66,0,54,54,0,40,40,0,10,10,0
,,Hispanic,22,21,1,20,20,0,16,15,1,10,10,0,6,6,0,6,6,0,0,0,0
,,Asian,4,4,0,4,4,0,4,4,0,3,3,0,3,3,0,3,3,0,0,0,0
,,Pacific Islander,1,1,0,1,1,0,0,0,0,1,1,0,1,1,0,0,0,0,0,0,0
,Minnesota,All Ethnicities,272,270,2,268,266,2,244,244,0,156,156,0,184,184,0,87,87,0,7,7,0
,,White,229,228,1,226,225,1,206,206,0,136,136,0,158,158,0,75,75,0,6,6,0
,,Black,17,17,0,17,17,0,16,16,0,8,8,0,12,12,0,3,3,0,1,1,0
,,Hispanic,16,15,1,16,15,1,14,14,0,7,7,0,11,11,0,6,6,0,0,0,0
,,Unknown,1,1,0,1,1,0,1,1,0,1,1,0,1,1,0,0,0,0,0,0,0
,,Asian,3,3,0,3,3,0,1,1,0,1,1,0,0,0,0,1,1,0,0,0,0
,,American Indian/Alaska Native,6,6,0,5,5,0,6,6,0,3,3,0,2,2,0,2,2,0,0,0,0
,Mississippi,All Ethnicities,223,223,0,217,217,0,184,184,0,134,134,0,92,92,0,53,53,0,13,13,0
,,White,166,166,0,161,161,0,137,137,0,93,93,0,67,67,0,36,36,0,12,12,0
,,Black,54,54,0,53,53,0,45,45,0,39,39,0,24,24,0,16,16,0,0,0,0
,,Hispanic,1,1,0,1,1,0,1,1,0,1,1,0,0,0,0,0,0,0,0,0,0
,,Asian,2,2,0,2,2,0,1,1,0,1,1,0,1,1,0,1,1,0,1,1,0
,Missouri,All Ethnicities,441,437,4,430,426,4,398,398,0,264,264,0,192,192,0,143,143,0,13,13,0
,,White,365,361,4,357,353,4,329,329,0,220,220,0,160,160,0,113,113,0,9,9,0
,,Black,65,65,0,63,63,0,59,59,0,39,39,0,29,29,0,25,25,0,3,3,0
,,Hispanic,6,6,0,6,6,0,5,5,0,3,3,0,2,2,0,3,3,0,0,0,0
,,Asian,2,2,0,2,2,0,2,2,0,1,1,0,1,1,0,2,2,0,1,1,0
,,American Indian/Alaska Native,2,2,0,1,1,0,2,2,0,0,0,0,0,0,0,0,0,0,0,0,0
,,Multiracial,1,1,0,1,1,0,1,1,0,1,1,0,0,0,0,0,0,0,0,0,0
,Montana,All Ethnicities,78,78,0,78,78,0,71,71,0,46,46,0,36,36,0,19,19,0,0,0,0
,,White,74,74,0,74,74,0,67,67,0,43,43,0,35,35,0,18,18,0,0,0,0
,,Hispanic,1,1,0,1,1,0,1,1,0,1,1,0,1,1,0,1,1,0,0,0,0
,,American Indian/Alaska Native,3,3,0,3,3,0,3,3,0,2,2,0,0,0,0,0,0,0,0,0,0
,Nebraska,All Ethnicities,132,132,0,131,131,0,124,124,0,68,68,0,86,86,0,33,33,0,6,6,0
,,White,117,117,0,116,116,0,110,110,0,58,58,0,78,78,0,27,27,0,5,5,0
,,Black,5,5,0,5,5,0,4,4,0,3,3,0,2,2,0,2,2,0,0,0,0
,,Hispanic,7,7,0,7,7,0,7,7,0,6,6,0,3,3,0,3,3,0,1,1,0
,,Asian,1,1,0,1,1,0,1,1,0,0,0,0,1,1,0,0,0,0,0,0,0
,,American Indian/Alaska Native,1,1,0,1,1,0,1,1,0,0,0,0,1,1,0,0,0,0,0,0,0
,,Multiracial,1,1,0,1,1,0,1,1,0,1,1,0,1,1,0,1,1,0,0,0,0
,,,,,,,,,,,,,,,,,,,,,,,
,,,,,,,,,,,,,,,,,,,,,,,
,Nevada,All Ethnicities,140,140,0,139,139,0,131,131,0,91,91,0,61,61,0,38,38,0,5,5,0
,,White,92,92,0,92,92,0,88,88,0,59,59,0,42,42,0,22,22,0,4,4,0
,,Black,12,12,0,12,12,0,10,10,0,6,6,0,3,3,0,4,4,0,0,0,0
,,Hispanic,28,28,0,27,27,0,26,26,0,21,21,0,12,12,0,9,9,0,1,1,0
,,Asian,4,4,0,4,4,0,4,4,0,2,2,0,2,2,0,1,1,0,0,0,0
,,American Indian/Alaska Native,1,1,0,1,1,0,0,0,0,1,1,0,0,0,0,0,0,0,0,0,0
,,Pacific Islander,1,1,0,1,1,0,1,1,0,0,0,0,0,0,0,1,1,0,0,0,0
,,Multiracial,2,2,0,2,2,0,2,2,0,2,2,0,2,2,0,1,1,0,0,0,0
,New Hampshire,All Ethnicities,55,55,0,53,53,0,43,43,0,27,27,0,27,27,0,12,12,0,0,0,0
,,White,55,55,0,53,53,0,43,43,0,27,27,0,27,27,0,12,12,0,0,0,0
,New Jersey,All Ethnicities,286,284,2,281,280,1,245,244,1,161,161,0,142,142,0,70,70,0,5,5,0
,,White,180,179,1,177,176,1,155,155,0,103,103,0,93,93,0,43,43,0,3,3,0
,,Black,54,53,1,52,52,0,43,42,1,28,28,0,21,21,0,13,13,0,1,1,0
,,Hispanic,43,43,0,43,43,0,38,38,0,23,23,0,21,21,0,9,9,0,0,0,0
,,Asian,6,6,0,6,6,0,6,6,0,5,5,0,5,5,0,2,2,0,1,1,0
,,Pacific Islander,1,1,0,1,1,0,1,1,0,0,0,0,1,1,0,1,1,0,0,0,0
,,Multiracial,2,2,0,2,2,0,2,2,0,2,2,0,1,1,0,2,2,0,0,0,0
,New Mexico,All Ethnicities,136,136,0,132,132,0,115,115,0,78,78,0,31,31,0,35,35,0,3,3,0
,,White,54,54,0,54,54,0,48,48,0,33,33,0,13,13,0,20,20,0,0,0,0
,,Black,4,4,0,4,4,0,4,4,0,2,2,0,1,1,0,0,0,0,0,0,0
,,Hispanic,70,70,0,66,66,0,57,57,0,37,37,0,16,16,0,14,14,0,3,3,0
,,Asian,2,2,0,2,2,0,2,2,0,1,1,0,0,0,0,0,0,0,0,0,0
,,American Indian/Alaska Native,6,6,0,6,6,0,4,4,0,5,5,0,1,1,0,1,1,0,0,0,0
,New York,All Ethnicities,600,596,4,580,578,2,504,502,2,350,350,0,252,252,0,130,130,0,22,22,0
,,White,357,356,1,347,347,0,301,300,1,202,202,0,164,164,0,76,76,0,13,13,0
,,Black,110,110,0,106,106,0,91,91,0,63,63,0,42,42,0,32,32,0,7,7,0
,,Hispanic,108,105,3,103,101,2,91,90,1,73,73,0,34,34,0,19,19,0,2,2,0
,,Unknown,1,1,0,1,1,0,0,0,0,0,0,0,0,0,0,0,0,0,0,0,0
,,Asian,13,13,0,13,13,0,11,11,0,4,4,0,7,7,0,3,3,0,0,0,0
,,American Indian/Alaska Native,2,2,0,2,2,0,2,2,0,2,2,0,1,1,0,0,0,0,0,0,0
,,Multiracial,9,9,0,8,8,0,8,8,0,6,6,0,4,4,0,0,0,0,0,0,0
,North Carolina,All Ethnicities,456,456,0,449,449,0,393,393,0,262,262,0,248,248,0,128,128,0,7,7,0
,,White,334,334,0,329,329,0,283,283,0,187,187,0,177,177,0,88,88,0,3,3,0
,,Black,100,100,0,98,98,0,91,91,0,61,61,0,59,59,0,31,31,0,4,4,0
,,Hispanic,12,12,0,12,12,0,10,10,0,6,6,0,6,6,0,3,3,0,0,0,0
,,Asian,2,2,0,2,2,0,2,2,0,2,2,0,1,1,0,2,2,0,0,0,0
,,American Indian/Alaska Native,8,8,0,8,8,0,7,7,0,6,6,0,5,5,0,4,4,0,0,0,0
,North Dakota,All Ethnicities,46,45,1,45,44,1,40,40,0,24,24,0,30,30,0,11,11,0,1,1,0
,,White,41,40,1,40,39,1,35,35,0,21,21,0,26,26,0,9,9,0,0,0,0
,,Black,1,1,0,1,1,0,1,1,0,1,1,0,1,1,0,0,0,0,1,1,0
,,Hispanic,1,1,0,1,1,0,1,1,0,1,1,0,1,1,0,1,1,0,0,0,0
,,,,,,,,,,,,,,,,,,,,,,,
,,,,,,,,,,,,,,,,,,,,,,,
,,American Indian/Alaska Native,3,3,0,3,3,0,3,3,0,1,1,0,2,2,0,1,1,0,0,0,0
,Ohio,All Ethnicities,634,630,4,626,622,4,552,552,0,364,364,0,364,364,0,199,199,0,21,21,0
,,White,514,510,4,508,504,4,444,444,0,293,293,0,299,299,0,153,153,0,16,16,0
,,Black,102,102,0,100,100,0,92,92,0,61,61,0,52,52,0,41,41,0,3,3,0
,,Hispanic,8,8,0,8,8,0,6,6,0,6,6,0,5,5,0,3,3,0,0,0,0
,,Unknown,1,1,0,1,1,0,1,1,0,1,1,0,0,0,0,0,0,0,0,0,0
,,Asian,5,5,0,5,5,0,5,5,0,3,3,0,5,5,0,0,0,0,1,1,0
,,American Indian/Alaska Native,1,1,0,1,1,0,1,1,0,0,0,0,0,0,0,0,0,0,0,0,0
,,Multiracial,3,3,0,3,3,0,3,3,0,0,0,0,3,3,0,2,2,0,1,1,0
,Oklahoma,All Ethnicities,285,282,3,278,275,3,253,253,0,160,160,0,77,77,0,64,64,0,2,2,0
,,White,232,231,1,229,228,1,207,207,0,130,130,0,63,63,0,55,55,0,2,2,0
,,Black,26,26,0,25,25,0,23,23,0,16,16,0,4,4,0,5,5,0,0,0,0
,,Hispanic,16,15,1,14,13,1,13,13,0,8,8,0,6,6,0,3,3,0,0,0,0
,,American Indian/Alaska Native,11,10,1,10,9,1,10,10,0,6,6,0,4,4,0,1,1,0,0,0,0
,Oregon,All Ethnicities,189,189,0,188,188,0,169,169,0,91,91,0,78,78,0,38,38,0,1,1,0
,,White,169,169,0,168,168,0,151,151,0,84,84,0,72,72,0,36,36,0,0,0,0
,,Black,5,5,0,5,5,0,5,5,0,1,1,0,2,2,0,0,0,0,0,0,0
,,Hispanic,8,8,0,8,8,0,7,7,0,6,6,0,3,3,0,0,0,0,1,1,0
,,Asian,4,4,0,4,4,0,3,3,0,0,0,0,0,0,0,1,1,0,0,0,0
,,American Indian/Alaska Native,2,2,0,2,2,0,2,2,0,0,0,0,0,0,0,0,0,0,0,0,0
,,Pacific Islander,1,1,0,1,1,0,1,1,0,0,0,0,1,1,0,1,1,0,0,0,0
,Pennsylvania,All Ethnicities,693,691,2,675,675,0,613,611,2,386,386,0,365,365,0,210,210,0,24,24,0
,,White,544,542,2,531,531,0,481,479,2,301,301,0,285,285,0,156,156,0,19,19,0
,,Black,112,112,0,109,109,0,98,98,0,63,63,0,61,61,0,40,40,0,5,5,0
,,Hispanic,29,29,0,27,27,0,26,26,0,16,16,0,16,16,0,10,10,0,0,0,0
,,Asian,3,3,0,3,3,0,3,3,0,3,3,0,2,2,0,3,3,0,0,0,0
,,American Indian/Alaska Native,1,1,0,1,1,0,1,1,0,0,0,0,0,0,0,0,0,0,0,0,0
,,Multiracial,4,4,0,4,4,0,4,4,0,3,3,0,1,1,0,1,1,0,0,0,0
,Puerto Rico,All Ethnicities,112,111,1,111,110,1,89,89,0,48,48,0,41,41,0,27,27,0,5,5,0
,,White,2,2,0,2,2,0,1,1,0,1,1,0,0,0,0,0,0,0,0,0,0
,,Black,1,1,0,1,1,0,1,1,0,1,1,0,1,1,0,1,1,0,0,0,0
,,Hispanic,92,91,1,91,90,1,71,71,0,36,36,0,30,30,0,16,16,0,5,5,0
,,Multiracial,17,17,0,17,17,0,16,16,0,10,10,0,10,10,0,10,10,0,0,0,0
,Rhode Island,All Ethnicities,23,23,0,21,21,0,19,19,0,16,16,0,13,13,0,4,4,0,0,0,0
,,White,18,18,0,16,16,0,15,15,0,12,12,0,11,11,0,4,4,0,0,0,0
,,Black,2,2,0,2,2,0,1,1,0,1,1,0,0,0,0,0,0,0,0,0,0
,,Hispanic,1,1,0,1,1,0,1,1,0,1,1,0,1,1,0,0,0,0,0,0,0
,,Asian,1,1,0,1,1,0,1,1,0,1,1,0,1,1,0,0,0,0,0,0,0
,,Multiracial,1,1,0,1,1,0,1,1,0,1,1,0,0,0,0,0,0,0,0,0,0
,South Carolina,All Ethnicities,275,273,2,272,271,1,247,246,1,178,178,0,133,133,0,86,86,0,4,4,0
,,White,187,186,1,187,186,1,165,165,0,116,116,0,94,94,0,61,61,0,2,2,0
,,,,,,,,,,,,,,,,,,,,,,,
,,,,,,,,,,,,,,,,,,,,,,,
,,Black,72,72,0,70,70,0,68,68,0,55,55,0,32,32,0,23,23,0,1,1,0
,,Hispanic,11,10,1,10,10,0,10,9,1,5,5,0,5,5,0,1,1,0,0,0,0
,,Unknown,1,1,0,1,1,0,0,0,0,0,0,0,1,1,0,0,0,0,0,0,0
,,Asian,2,2,0,2,2,0,2,2,0,1,1,0,1,1,0,1,1,0,0,0,0
,,American Indian/Alaska Native,1,1,0,1,1,0,1,1,0,1,1,0,0,0,0,0,0,0,1,1,0
,,Multiracial,1,1,0,1,1,0,1,1,0,0,0,0,0,0,0,0,0,0,0,0,0
,South Dakota,All Ethnicities,51,51,0,51,51,0,45,45,0,27,27,0,36,36,0,23,23,0,2,2,0
,,White,40,40,0,40,40,0,35,35,0,22,22,0,28,28,0,17,17,0,2,2,0
,,Black,2,2,0,2,2,0,2,2,0,1,1,0,1,1,0,2,2,0,0,0,0
,,Hispanic,1,1,0,1,1,0,1,1,0,0,0,0,1,1,0,1,1,0,0,0,0
,,Asian,1,1,0,1,1,0,0,0,0,0,0,0,0,0,0,0,0,0,0,0,0
,,American Indian/Alaska Native,7,7,0,7,7,0,7,7,0,4,4,0,6,6,0,3,3,0,0,0,0
,State unassigned,All Ethnicities,277,273,4,268,265,3,213,212,1,154,154,0,79,79,0,54,54,0,3,3,0
,,White,128,125,3,121,119,2,94,93,1,71,71,0,27,27,0,22,22,0,1,1,0
,,Black,42,42,0,41,41,0,33,33,0,27,27,0,18,18,0,12,12,0,1,1,0
,,Hispanic,82,82,0,81,81,0,66,66,0,46,46,0,28,28,0,14,14,0,1,1,0
,,Unknown,15,14,1,15,14,1,12,12,0,6,6,0,4,4,0,6,6,0,0,0,0
,,Asian,9,9,0,9,9,0,7,7,0,4,4,0,2,2,0,0,0,0,0,0,0
,,Pacific Islander,1,1,0,1,1,0,1,1,0,0,0,0,0,0,0,0,0,0,0,0,0
,Tennessee,All Ethnicities,404,403,1,394,393,1,348,348,0,247,247,0,210,210,0,124,124,0,11,11,0
,,White,320,319,1,312,311,1,273,273,0,197,197,0,159,159,0,94,94,0,8,8,0
,,Black,67,67,0,66,66,0,59,59,0,37,37,0,37,37,0,23,23,0,2,2,0
,,Hispanic,13,13,0,12,12,0,12,12,0,10,10,0,10,10,0,6,6,0,0,0,0
,,Asian,2,2,0,2,2,0,2,2,0,1,1,0,2,2,0,1,1,0,1,1,0
,,American Indian/Alaska Native,1,1,0,1,1,0,1,1,0,1,1,0,1,1,0,0,0,0,0,0,0
,,Multiracial,1,1,0,1,1,0,1,1,0,1,1,0,1,1,0,0,0,0,0,0,0
,Texas,All Ethnicities,1503,1499,4,1461,1458,3,1309,1308,1,929,929,0,523,523,0,440,440,0,19,19,0
,,White,852,849,3,829,827,2,741,740,1,523,523,0,296,296,0,241,241,0,12,12,0
,,Black,181,181,0,174,174,0,161,161,0,118,118,0,68,68,0,59,59,0,2,2,0
,,Hispanic,444,443,1,433,432,1,388,388,0,269,269,0,151,151,0,138,138,0,5,5,0
,,Unknown,2,2,0,2,2,0,2,2,0,2,2,0,0,0,0,0,0,0,0,0,0
,,Asian,18,18,0,17,17,0,11,11,0,11,11,0,5,5,0,1,1,0,0,0,0
,,American Indian/Alaska Native,1,1,0,1,1,0,1,1,0,1,1,0,0,0,0,0,0,0,0,0,0
,,Multiracial,5,5,0,5,5,0,5,5,0,5,5,0,3,3,0,1,1,0,0,0,0
,Utah,All Ethnicities,195,195,0,189,189,0,167,167,0,94,94,0,78,78,0,38,38,0,2,2,0
,,White,175,175,0,169,169,0,148,148,0,84,84,0,71,71,0,36,36,0,2,2,0
,,Black,2,2,0,2,2,0,2,2,0,0,0,0,0,0,0,0,0,0,0,0,0
,,Hispanic,15,15,0,15,15,0,14,14,0,7,7,0,5,5,0,2,2,0,0,0,0
,,Asian,3,3,0,3,3,0,3,3,0,3,3,0,2,2,0,0,0,0,0,0,0
,Vermont,All Ethnicities,35,35,0,35,35,0,32,32,0,20,20,0,13,13,0,9,9,0,1,1,0
,,White,33,33,0,33,33,0,31,31,0,20,20,0,13,13,0,9,9,0,1,1,0
,,,,,,,,,,,,,,,,,,,,,,,
,,,,,,,,,,,,,,,,,,,,,,,
,,Black,1,1,0,1,1,0,1,1,0,0,0,0,0,0,0,0,0,0,0,0,0
,,Unknown,1,1,0,1,1,0,0,0,0,0,0,0,0,0,0,0,0,0,0,0,0
,Virginia,All Ethnicities,358,356,2,349,348,1,314,313,1,209,209,0,153,153,0,98,98,0,8,8,0
,,White,255,255,0,251,251,0,228,228,0,150,150,0,110,110,0,69,69,0,4,4,0
,,Black,75,74,1,72,71,1,61,61,0,43,43,0,29,29,0,23,23,0,4,4,0
,,Hispanic,15,14,1,14,14,0,14,13,1,8,8,0,5,5,0,2,2,0,0,0,0
,,Asian,9,9,0,8,8,0,7,7,0,4,4,0,5,5,0,2,2,0,0,0,0
,,American Indian/Alaska Native,1,1,0,1,1,0,1,1,0,1,1,0,1,1,0,0,0,0,0,0,0
,,Pacific Islander,1,1,0,1,1,0,1,1,0,1,1,0,1,1,0,1,1,0,0,0,0
,,Multiracial,2,2,0,2,2,0,2,2,0,2,2,0,2,2,0,1,1,0,0,0,0
,Washington,All Ethnicities,277,277,0,270,270,0,251,251,0,149,149,0,121,121,0,65,65,0,2,2,0
,,White,222,222,0,218,218,0,201,201,0,116,116,0,93,93,0,51,51,0,2,2,0
,,Black,15,15,0,14,14,0,14,14,0,8,8,0,9,9,0,5,5,0,0,0,0
,,Hispanic,21,21,0,21,21,0,19,19,0,17,17,0,8,8,0,6,6,0,0,0,0
,,Asian,8,8,0,6,6,0,7,7,0,3,3,0,4,4,0,2,2,0,0,0,0
,,American Indian/Alaska Native,6,6,0,6,6,0,5,5,0,2,2,0,3,3,0,0,0,0,0,0,0
,,Pacific Islander,2,2,0,2,2,0,2,2,0,0,0,0,2,2,0,0,0,0,0,0,0
,,Multiracial,3,3,0,3,3,0,3,3,0,3,3,0,2,2,0,1,1,0,0,0,0
,West Virginia,All Ethnicities,118,118,0,117,117,0,103,103,0,62,62,0,61,61,0,31,31,0,4,4,0
,,White,106,106,0,105,105,0,91,91,0,52,52,0,54,54,0,28,28,0,4,4,0
,,Black,11,11,0,11,11,0,11,11,0,9,9,0,6,6,0,3,3,0,0,0,0
,,Hispanic,1,1,0,1,1,0,1,1,0,1,1,0,1,1,0,0,0,0,0,0,0
,Wisconsin,All Ethnicities,366,364,2,365,363,2,328,328,0,204,204,0,273,273,0,89,89,0,7,7,0
,,White,311,310,1,310,309,1,279,279,0,167,167,0,239,239,0,66,66,0,7,7,0
,,Black,34,34,0,34,34,0,30,30,0,24,24,0,20,20,0,14,14,0,0,0,0
,,Hispanic,14,14,0,14,14,0,13,13,0,10,10,0,9,9,0,6,6,0,0,0,0
,,Asian,5,4,1,5,4,1,4,4,0,1,1,0,3,3,0,3,3,0,0,0,0
,,American Indian/Alaska Native,1,1,0,1,1,0,1,1,0,1,1,0,1,1,0,0,0,0,0,0,0
,,Multiracial,1,1,0,1,1,0,1,1,0,1,1,0,1,1,0,0,0,0,0,0,0
,Wyoming,All Ethnicities,47,47,0,45,45,0,41,41,0,35,35,0,23,23,0,14,14,0,0,0,0
,,White,46,46,0,44,44,0,40,40,0,34,34,0,22,22,0,14,14,0,0,0,0
,,Hispanic,1,1,0,1,1,0,1,1,0,1,1,0,1,1,0,0,0,0,0,0,0
18-34 Years,All Donor States of Residence,All Ethnicities,118246,63600,54646,111623,60738,50885,58036,54491,3545,35821,35804,17,24124,24101,23,17341,17176,165,830,803,27
,,White,77054,43806,33248,72464,41963,30501,39848,37277,2571,24211,24195,16,16562,16543,19,11090,10954,136,572,558,14
,,Black,17825,9053,8772,17039,8504,8535,8220,7992,228,5325,5325,0,3693,3693,0,3109,3106,3,139,132,7
,,Hispanic,18426,8828,9598,17453,8435,9018,8148,7596,552,5323,5322,1,3176,3174,2,2603,2580,23,89,83,6
,,Unknown,99,55,44,93,52,41,47,45,2,27,27,0,24,24,0,7,6,1,1,1,0
,,Asian,2776,920,1856,2613,882,1731,897,773,124,461,461,0,331,329,2,268,267,1,17,17,0
,,American Indian/Alaska Native,654,307,347,625,295,330,264,247,17,167,167,0,106,106,0,85,85,0,2,2,0
,,Pacific Islander,467,156,311,451,152,299,143,132,11,67,67,0,53,53,0,38,37,1,2,2,0
,,Multiracial,945,475,470,885,455,430,469,429,40,240,240,0,179,179,0,141,141,0,8,8,0
,,,,,,,,,,,,,,,,,,,,,,,
,,,,,,,,,,,,,,,,,,,,,,,
,Alabama,All Ethnicities,2063,1170,893,2008,1128,880,1015,1004,11,629,627,2,363,363,0,298,298,0,4,4,0
,,White,1444,877,567,1404,850,554,755,744,11,463,461,2,255,255,0,199,199,0,2,2,0
,,Black,577,274,303,562,259,303,244,244,0,152,152,0,103,103,0,96,96,0,2,2,0
,,Hispanic,24,12,12,24,12,12,11,11,0,10,10,0,4,4,0,2,2,0,0,0,0
,,Asian,16,6,10,16,6,10,4,4,0,3,3,0,1,1,0,1,1,0,0,0,0
,,American Indian/Alaska Native,1,0,1,1,0,1,0,0,0,0,0,0,0,0,0,0,0,0,0,0,0
,,Multiracial,1,1,0,1,1,0,1,1,0,1,1,0,0,0,0,0,0,0,0,0,0
,Alaska,All Ethnicities,317,209,108,306,205,101,189,182,7,111,111,0,88,88,0,66,66,0,0,0,0
,,White,230,152,78,222,149,73,139,134,5,82,82,0,63,63,0,48,48,0,0,0,0
,,Black,20,12,8,19,12,7,13,12,1,6,6,0,8,8,0,5,5,0,0,0,0
,,Hispanic,7,5,2,6,4,2,4,4,0,4,4,0,2,2,0,1,1,0,0,0,0
,,Asian,8,4,4,7,4,3,5,4,1,3,3,0,1,1,0,2,2,0,0,0,0
,,American Indian/Alaska Native,45,35,10,45,35,10,27,27,0,15,15,0,13,13,0,10,10,0,0,0,0
,,Pacific Islander,4,0,4,4,0,4,0,0,0,0,0,0,0,0,0,0,0,0,0,0,0
,,Multiracial,3,1,2,3,1,2,1,1,0,1,1,0,1,1,0,0,0,0,0,0,0
,Arizona,All Ethnicities,2351,1248,1103,2264,1220,1044,1142,1089,53,669,668,1,410,410,0,374,369,5,10,10,0
,,White,1470,827,643,1406,807,599,752,714,38,441,440,1,266,266,0,232,227,5,7,7,0
,,Black,114,58,56,111,57,54,58,56,2,35,35,0,23,23,0,24,24,0,0,0,0
,,Hispanic,626,314,312,609,308,301,291,280,11,167,167,0,112,112,0,103,103,0,3,3,0
,,Asian,22,9,13,21,9,12,10,9,1,7,7,0,2,2,0,4,4,0,0,0,0
,,American Indian/Alaska Native,85,26,59,83,25,58,18,17,1,11,11,0,4,4,0,8,8,0,0,0,0
,,Pacific Islander,6,0,6,6,0,6,0,0,0,0,0,0,0,0,0,0,0,0,0,0,0
,,Multiracial,28,14,14,28,14,14,13,13,0,8,8,0,3,3,0,3,3,0,0,0,0
,Arkansas,All Ethnicities,1085,699,386,1034,665,369,625,608,17,421,421,0,246,246,0,197,197,0,23,23,0
,,White,854,569,285,818,548,270,511,496,15,338,338,0,196,196,0,153,153,0,19,19,0
,,Black,188,106,82,174,93,81,94,93,1,68,68,0,40,40,0,37,37,0,4,4,0
,,Hispanic,32,20,12,32,20,12,17,17,0,12,12,0,9,9,0,7,7,0,0,0,0
,,Asian,6,2,4,5,2,3,3,2,1,1,1,0,1,1,0,0,0,0,0,0,0
,,American Indian/Alaska Native,2,0,2,2,0,2,0,0,0,0,0,0,0,0,0,0,0,0,0,0,0
,,Multiracial,3,2,1,3,2,1,0,0,0,2,2,0,0,0,0,0,0,0,0,0,0
,California,All Ethnicities,12272,6324,5948,11534,6091,5443,5998,5545,453,3939,3934,5,2349,2349,0,1858,1812,46,26,25,1
,,White,5381,2991,2390,5028,2896,2132,2820,2596,224,1831,1827,4,1104,1104,0,767,737,30,9,9,0
,,Black,1098,602,496,1048,574,474,562,543,19,387,387,0,240,240,0,209,207,2,4,3,1
,,Hispanic,4637,2309,2328,4374,2218,2156,2194,2036,158,1482,1481,1,866,866,0,754,741,13,8,8,0
,,Unknown,2,2,0,2,2,0,1,1,0,1,1,0,0,0,0,1,1,0,0,0,0
,,Asian,802,279,523,747,267,480,284,241,43,154,154,0,97,97,0,83,83,0,4,4,0
,,American Indian/Alaska Native,44,26,18,42,24,18,22,22,0,17,17,0,8,8,0,8,8,0,0,0,0
,,Pacific Islander,148,39,109,141,36,105,39,36,3,26,26,0,14,14,0,18,17,1,1,1,0
,,Multiracial,160,76,84,152,74,78,76,70,6,41,41,0,20,20,0,18,18,0,0,0,0
,Colorado,All Ethnicities,1753,925,828,1627,899,728,907,812,95,531,531,0,354,354,0,234,230,4,5,4,1
,,White,1260,700,560,1165,681,484,694,622,72,409,409,0,281,281,0,170,167,3,5,4,1
,,,,,,,,,,,,,,,,,,,,,,,
,,,,,,,,,,,,,,,,,,,,,,,
,,Black,85,47,38,79,44,35,46,43,3,31,31,0,18,18,0,21,21,0,0,0,0
,,Hispanic,349,159,190,327,155,172,147,130,17,81,81,0,51,51,0,36,35,1,0,0,0
,,Unknown,1,1,0,1,1,0,1,1,0,1,1,0,0,0,0,0,0,0,0,0,0
,,Asian,34,11,23,34,11,23,10,10,0,4,4,0,2,2,0,3,3,0,0,0,0
,,American Indian/Alaska Native,12,7,5,12,7,5,6,6,0,5,5,0,2,2,0,4,4,0,0,0,0
,,Pacific Islander,2,0,2,2,0,2,0,0,0,0,0,0,0,0,0,0,0,0,0,0,0
,,Multiracial,10,0,10,7,0,7,3,0,3,0,0,0,0,0,0,0,0,0,0,0,0
,Connecticut,All Ethnicities,1108,553,555,1038,533,505,510,460,50,303,303,0,181,181,0,108,108,0,5,5,0
,,White,763,404,359,716,392,324,358,323,35,209,209,0,124,124,0,74,74,0,2,2,0
,,Black,127,50,77,116,44,72,52,47,5,30,30,0,15,15,0,13,13,0,1,1,0
,,Hispanic,190,89,101,181,88,93,90,82,8,57,57,0,37,37,0,18,18,0,2,2,0
,,Asian,14,4,10,12,4,8,6,4,2,3,3,0,3,3,0,1,1,0,0,0,0
,,American Indian/Alaska Native,3,1,2,3,1,2,1,1,0,1,1,0,1,1,0,1,1,0,0,0,0
,,Pacific Islander,3,1,2,3,1,2,0,0,0,1,1,0,0,0,0,0,0,0,0,0,0
,,Multiracial,8,4,4,7,3,4,3,3,0,2,2,0,1,1,0,1,1,0,0,0,0
,Delaware,All Ethnicities,415,269,146,393,259,134,236,224,12,152,152,0,116,115,1,83,83,0,4,4,0
,,White,302,202,100,285,195,90,176,166,10,108,108,0,74,73,1,53,53,0,1,1,0
,,Black,82,47,35,79,45,34,43,42,1,30,30,0,28,28,0,22,22,0,2,2,0
,,Hispanic,21,13,8,21,13,8,11,11,0,10,10,0,10,10,0,5,5,0,0,0,0
,,Asian,8,5,3,6,4,2,4,3,1,2,2,0,2,2,0,2,2,0,0,0,0
,,Multiracial,2,2,0,2,2,0,2,2,0,2,2,0,2,2,0,1,1,0,1,1,0
,District of Columbia,All Ethnicities,382,161,221,364,157,207,149,135,14,104,104,0,95,95,0,57,57,0,4,4,0
,,White,98,29,69,92,28,64,31,26,5,15,15,0,16,16,0,9,9,0,0,0,0
,,Black,245,118,127,236,116,120,104,97,7,80,80,0,71,71,0,42,42,0,3,3,0
,,Hispanic,27,12,15,26,12,14,11,10,1,7,7,0,6,6,0,4,4,0,0,0,0
,,Asian,10,2,8,8,1,7,3,2,1,2,2,0,2,2,0,2,2,0,1,1,0
,,American Indian/Alaska Native,1,0,1,1,0,1,0,0,0,0,0,0,0,0,0,0,0,0,0,0,0
,,Multiracial,1,0,1,1,0,1,0,0,0,0,0,0,0,0,0,0,0,0,0,0,0
,Florida,All Ethnicities,6005,4131,1874,5705,3901,1804,3646,3581,65,2183,2182,1,1458,1458,0,1066,1062,4,87,87,0
,,White,3872,2789,1083,3652,2623,1029,2423,2374,49,1416,1415,1,922,922,0,680,676,4,49,49,0
,,Black,989,622,367,947,585,362,573,568,5,356,356,0,252,252,0,199,199,0,17,17,0
,,Hispanic,1038,656,382,1003,631,372,593,583,10,366,366,0,257,257,0,170,170,0,19,19,0
,,Unknown,5,4,1,4,3,1,4,4,0,3,3,0,2,2,0,2,2,0,0,0,0
,,Asian,63,34,29,61,33,28,30,29,1,21,21,0,9,9,0,9,9,0,1,1,0
,,American Indian/Alaska Native,7,5,2,7,5,2,5,5,0,5,5,0,4,4,0,1,1,0,0,0,0
,,Pacific Islander,3,1,2,3,1,2,1,1,0,1,1,0,1,1,0,0,0,0,0,0,0
,,Multiracial,28,20,8,28,20,8,17,17,0,15,15,0,11,11,0,5,5,0,1,1,0
,Georgia,All Ethnicities,3104,1769,1335,2919,1636,1283,1604,1554,50,1089,1089,0,568,567,1,512,511,1,21,21,0
,,White,1917,1155,762,1795,1072,723,1045,1008,37,715,715,0,375,374,1,332,331,1,17,17,0
,,Black,919,476,443,870,435,435,430,422,8,285,285,0,149,149,0,144,144,0,4,4,0
,,Hispanic,194,109,85,183,102,81,101,97,4,76,76,0,38,38,0,29,29,0,0,0,0
,,,,,,,,,,,,,,,,,,,,,,,
,,,,,,,,,,,,,,,,,,,,,,,
,,Unknown,1,1,0,1,1,0,1,1,0,0,0,0,0,0,0,0,0,0,0,0,0
,,Asian,52,20,32,49,18,31,21,20,1,9,9,0,5,5,0,6,6,0,0,0,0
,,American Indian/Alaska Native,4,1,3,4,1,3,1,1,0,0,0,0,0,0,0,0,0,0,0,0,0
,,Pacific Islander,3,0,3,3,0,3,0,0,0,0,0,0,0,0,0,0,0,0,0,0,0
,,Multiracial,14,7,7,14,7,7,5,5,0,4,4,0,1,1,0,1,1,0,0,0,0
,Hawaii,All Ethnicities,351,195,156,337,193,144,166,154,12,31,31,0,64,64,0,14,14,0,0,0,0
,,White,106,67,39,102,67,35,51,47,4,12,12,0,26,26,0,6,6,0,0,0,0
,,Black,8,2,6,7,1,6,2,2,0,0,0,0,1,1,0,1,1,0,0,0,0
,,Hispanic,11,5,6,10,5,5,6,5,1,1,1,0,1,1,0,1,1,0,0,0,0
,,Unknown,2,1,1,2,1,1,1,1,0,0,0,0,0,0,0,0,0,0,0,0,0
,,Asian,82,36,46,80,36,44,34,32,2,5,5,0,11,11,0,1,1,0,0,0,0
,,Pacific Islander,105,66,39,100,66,34,57,52,5,12,12,0,20,20,0,5,5,0,0,0,0
,,Multiracial,37,18,19,36,17,19,15,15,0,1,1,0,5,5,0,0,0,0,0,0,0
,Idaho,All Ethnicities,484,270,214,463,261,202,248,237,11,153,152,1,93,93,0,65,65,0,1,1,0
,,White,434,246,188,418,239,179,225,217,8,137,136,1,87,87,0,59,59,0,1,1,0
,,Black,8,2,6,8,2,6,2,2,0,2,2,0,2,2,0,0,0,0,0,0,0
,,Hispanic,33,18,15,29,16,13,17,15,2,11,11,0,3,3,0,5,5,0,0,0,0
,,American Indian/Alaska Native,5,3,2,4,3,1,3,2,1,2,2,0,1,1,0,0,0,0,0,0,0
,,Pacific Islander,2,0,2,2,0,2,0,0,0,0,0,0,0,0,0,0,0,0,0,0,0
,,Multiracial,2,1,1,2,1,1,1,1,0,1,1,0,0,0,0,1,1,0,0,0,0
,Illinois,All Ethnicities,5857,2598,3259,5496,2479,3017,2396,2163,233,1384,1384,0,1253,1251,2,758,758,0,41,30,11
,,White,3245,1635,1610,3009,1564,1445,1483,1322,161,848,848,0,746,746,0,417,417,0,21,17,4
,,Black,1323,601,722,1264,567,697,559,537,22,338,338,0,326,326,0,221,221,0,14,10,4
,,Hispanic,1125,325,800,1067,313,754,319,275,44,184,184,0,168,167,1,109,109,0,6,3,3
,,Unknown,2,1,1,2,1,1,1,1,0,0,0,0,1,1,0,0,0,0,0,0,0
,,Asian,112,24,88,107,23,84,25,21,4,9,9,0,8,7,1,10,10,0,0,0,0
,,American Indian/Alaska Native,4,2,2,4,2,2,0,0,0,1,1,0,0,0,0,0,0,0,0,0,0
,,Pacific Islander,11,5,6,11,5,6,4,4,0,1,1,0,3,3,0,0,0,0,0,0,0
,,Multiracial,35,5,30,32,4,28,5,3,2,3,3,0,1,1,0,1,1,0,0,0,0
,Indiana,All Ethnicities,2572,1523,1049,2470,1448,1022,1374,1351,23,884,884,0,582,582,0,469,468,1,90,87,3
,,White,2131,1269,862,2046,1209,837,1142,1121,21,733,733,0,477,477,0,377,376,1,78,75,3
,,Black,309,196,113,293,182,111,181,179,2,118,118,0,82,82,0,77,77,0,10,10,0
,,Hispanic,106,49,57,105,48,57,43,43,0,28,28,0,18,18,0,13,13,0,1,1,0
,,Asian,19,7,12,19,7,12,7,7,0,3,3,0,4,4,0,2,2,0,1,1,0
,,Pacific Islander,2,1,1,2,1,1,1,1,0,1,1,0,1,1,0,0,0,0,0,0,0
,,Multiracial,5,1,4,5,1,4,0,0,0,1,1,0,0,0,0,0,0,0,0,0,0
,Iowa,All Ethnicities,1082,550,532,1038,536,502,507,479,28,295,295,0,247,246,1,151,150,1,7,6,1
,,White,992,511,481,950,498,452,470,443,27,274,274,0,235,234,1,136,135,1,7,6,1
,,Black,45,23,22,45,23,22,20,20,0,13,13,0,8,8,0,10,10,0,0,0,0
,,Hispanic,36,12,24,34,11,23,13,12,1,6,6,0,2,2,0,4,4,0,0,0,0
,,Asian,9,4,5,9,4,5,4,4,0,2,2,0,2,2,0,1,1,0,0,0,0
,,,,,,,,,,,,,,,,,,,,,,,
,,,,,,,,,,,,,,,,,,,,,,,
,Kansas,All Ethnicities,1108,758,350,1071,736,335,666,653,13,401,401,0,318,318,0,215,213,2,8,8,0
,,White,876,601,275,845,583,262,529,518,11,315,315,0,255,255,0,157,155,2,7,7,0
,,Black,96,59,37,93,57,36,54,53,1,31,31,0,22,22,0,24,24,0,0,0,0
,,Hispanic,112,84,28,111,83,28,71,71,0,47,47,0,35,35,0,27,27,0,0,0,0
,,Asian,12,8,4,12,8,4,6,6,0,4,4,0,3,3,0,2,2,0,0,0,0
,,American Indian/Alaska Native,8,6,2,7,5,2,5,5,0,4,4,0,3,3,0,5,5,0,1,1,0
,,Pacific Islander,2,0,2,2,0,2,0,0,0,0,0,0,0,0,0,0,0,0,0,0,0
,,Multiracial,2,0,2,1,0,1,1,0,1,0,0,0,0,0,0,0,0,0,0,0,0
,Kentucky,All Ethnicities,1551,936,615,1484,891,593,831,810,21,513,513,0,387,386,1,236,236,0,7,7,0
,,White,1363,823,540,1300,781,519,726,706,20,451,451,0,334,333,1,195,195,0,7,7,0
,,Black,143,86,57,140,84,56,82,81,1,47,47,0,40,40,0,37,37,0,0,0,0
,,Hispanic,28,18,10,27,17,10,17,17,0,10,10,0,8,8,0,1,1,0,0,0,0
,,Asian,11,4,7,11,4,7,3,3,0,2,2,0,3,3,0,2,2,0,0,0,0
,,American Indian/Alaska Native,2,2,0,2,2,0,1,1,0,1,1,0,1,1,0,0,0,0,0,0,0
,,Pacific Islander,2,1,1,2,1,1,0,0,0,1,1,0,0,0,0,0,0,0,0,0,0
,,Multiracial,2,2,0,2,2,0,2,2,0,1,1,0,1,1,0,1,1,0,0,0,0
,Louisiana,All Ethnicities,2074,1296,778,1962,1213,749,1208,1181,27,750,750,0,529,529,0,374,372,2,12,12,0
,,White,1317,883,434,1254,837,417,821,806,15,518,518,0,368,368,0,245,243,2,5,5,0
,,Black,672,367,305,633,336,297,342,334,8,204,204,0,147,147,0,117,117,0,7,7,0
,,Hispanic,53,29,24,45,23,22,29,27,2,19,19,0,6,6,0,9,9,0,0,0,0
,,Asian,23,13,10,22,13,9,13,12,1,8,8,0,7,7,0,3,3,0,0,0,0
,,American Indian/Alaska Native,7,3,4,6,3,3,2,1,1,1,1,0,1,1,0,0,0,0,0,0,0
,,Pacific Islander,1,0,1,1,0,1,0,0,0,0,0,0,0,0,0,0,0,0,0,0,0
,,Multiracial,1,1,0,1,1,0,1,1,0,0,0,0,0,0,0,0,0,0,0,0,0
,Maine,All Ethnicities,478,284,194,440,277,163,267,240,27,157,157,0,99,99,0,66,62,4,3,3,0
,,White,458,276,182,422,269,153,258,233,25,151,151,0,96,96,0,64,60,4,3,3,0
,,Black,9,2,7,8,2,6,3,2,1,1,1,0,1,1,0,0,0,0,0,0,0
,,Hispanic,7,4,3,7,4,3,3,3,0,4,4,0,2,2,0,2,2,0,0,0,0
,,Asian,3,1,2,2,1,1,2,1,1,1,1,0,0,0,0,0,0,0,0,0,0
,,Multiracial,1,1,0,1,1,0,1,1,0,0,0,0,0,0,0,0,0,0,0,0,0
,Maryland,All Ethnicities,2700,1229,1471,2529,1178,1351,1208,1088,120,677,677,0,629,629,0,403,403,0,16,16,0
,,White,1429,748,681,1322,725,597,745,661,84,377,377,0,371,371,0,227,227,0,9,9,0
,,Black,1038,388,650,981,360,621,379,350,29,246,246,0,210,210,0,142,142,0,4,4,0
,,Hispanic,134,67,67,131,67,64,60,57,3,43,43,0,36,36,0,24,24,0,2,2,0
,,Unknown,2,0,2,2,0,2,0,0,0,0,0,0,0,0,0,0,0,0,0,0,0
,,Asian,61,17,44,57,17,40,16,12,4,8,8,0,7,7,0,7,7,0,1,1,0
,,American Indian/Alaska Native,3,1,2,3,1,2,0,0,0,0,0,0,0,0,0,0,0,0,0,0,0
,,Pacific Islander,12,3,9,12,3,9,3,3,0,0,0,0,2,2,0,1,1,0,0,0,0
,,Multiracial,21,5,16,21,5,16,5,5,0,3,3,0,3,3,0,2,2,0,0,0,0
,Massachusetts,All Ethnicities,2258,1028,1230,2081,979,1102,950,837,113,530,530,0,296,295,1,211,198,13,10,9,1
,,White,1742,823,919,1594,784,810,753,659,94,406,406,0,222,221,1,158,145,13,8,7,1
,,,,,,,,,,,,,,,,,,,,,,,
,,,,,,,,,,,,,,,,,,,,,,,
,,Black,183,69,114,178,67,111,61,58,3,46,46,0,24,24,0,19,19,0,1,1,0
,,Hispanic,259,119,140,240,112,128,118,106,12,71,71,0,45,45,0,30,30,0,0,0,0
,,Unknown,1,1,0,1,1,0,1,1,0,1,1,0,1,1,0,0,0,0,0,0,0
,,Asian,54,12,42,50,11,39,13,10,3,5,5,0,3,3,0,4,4,0,1,1,0
,,American Indian/Alaska Native,2,1,1,2,1,1,0,0,0,0,0,0,0,0,0,0,0,0,0,0,0
,,Pacific Islander,1,0,1,1,0,1,0,0,0,0,0,0,0,0,0,0,0,0,0,0,0
,,Multiracial,16,3,13,15,3,12,4,3,1,1,1,0,1,1,0,0,0,0,0,0,0
,Michigan,All Ethnicities,4295,2127,2168,4100,2038,2062,1813,1708,105,1094,1094,0,682,682,0,605,604,1,37,37,0
,,White,3263,1672,1591,3110,1610,1500,1415,1325,90,854,854,0,547,547,0,450,449,1,27,27,0
,,Black,786,370,416,752,345,407,321,312,9,202,202,0,114,114,0,130,130,0,9,9,0
,,Hispanic,160,61,99,153,59,94,61,56,5,28,28,0,17,17,0,18,18,0,0,0,0
,,Unknown,1,0,1,1,0,1,0,0,0,0,0,0,0,0,0,0,0,0,0,0,0
,,Asian,57,15,42,56,15,41,11,10,1,8,8,0,4,4,0,6,6,0,1,1,0
,,American Indian/Alaska Native,14,7,7,14,7,7,5,5,0,1,1,0,0,0,0,0,0,0,0,0,0
,,Pacific Islander,4,0,4,4,0,4,0,0,0,0,0,0,0,0,0,0,0,0,0,0,0
,,Multiracial,10,2,8,10,2,8,0,0,0,1,1,0,0,0,0,1,1,0,0,0,0
,Minnesota,All Ethnicities,2485,900,1585,2352,877,1475,886,787,99,538,537,1,585,577,8,268,263,5,27,24,3
,,White,2094,804,1290,1975,785,1190,793,702,91,477,476,1,528,521,7,231,227,4,25,23,2
,,Black,157,42,115,154,42,112,41,39,2,32,32,0,31,31,0,20,20,0,1,0,1
,,Hispanic,88,21,67,82,19,63,21,17,4,13,13,0,8,8,0,5,5,0,0,0,0
,,Unknown,1,0,1,0,0,0,0,0,0,0,0,0,0,0,0,1,0,1,0,0,0
,,Asian,84,15,69,82,13,69,12,12,0,6,6,0,10,9,1,7,7,0,1,1,0
,,American Indian/Alaska Native,49,15,34,47,15,32,16,14,2,8,8,0,6,6,0,2,2,0,0,0,0
,,Pacific Islander,5,1,4,5,1,4,1,1,0,1,1,0,1,1,0,1,1,0,0,0,0
,,Multiracial,7,2,5,7,2,5,2,2,0,1,1,0,1,1,0,1,1,0,0,0,0
,Mississippi,All Ethnicities,929,577,352,887,553,334,489,475,14,304,303,1,197,197,0,144,141,3,8,8,0
,,White,639,407,232,610,393,217,348,336,12,208,207,1,137,137,0,88,86,2,6,6,0
,,Black,272,158,114,262,149,113,131,130,1,92,92,0,58,58,0,52,52,0,2,2,0
,,Hispanic,10,9,1,9,9,0,7,7,0,3,3,0,2,2,0,4,3,1,0,0,0
,,Asian,4,1,3,3,0,3,1,1,0,1,1,0,0,0,0,0,0,0,0,0,0
,,American Indian/Alaska Native,1,0,1,1,0,1,0,0,0,0,0,0,0,0,0,0,0,0,0,0,0
,,Pacific Islander,1,1,0,1,1,0,0,0,0,0,0,0,0,0,0,0,0,0,0,0,0
,,Multiracial,2,1,1,1,1,0,2,1,1,0,0,0,0,0,0,0,0,0,0,0,0
,Missouri,All Ethnicities,2543,1651,892,2409,1551,858,1453,1420,33,907,907,0,601,601,0,554,553,1,27,27,0
,,White,2022,1309,713,1916,1235,681,1159,1128,31,720,720,0,472,472,0,415,414,1,18,18,0
,,Black,423,284,139,400,262,138,244,243,1,157,157,0,105,105,0,116,116,0,7,7,0
,,Hispanic,62,37,25,59,34,25,34,34,0,19,19,0,16,16,0,14,14,0,0,0,0
,,Asian,23,11,12,21,10,11,8,7,1,5,5,0,3,3,0,5,5,0,2,2,0
,,American Indian/Alaska Native,6,5,1,6,5,1,4,4,0,2,2,0,3,3,0,2,2,0,0,0,0
,,Pacific Islander,6,5,1,6,5,1,4,4,0,4,4,0,2,2,0,2,2,0,0,0,0
,,Multiracial,1,0,1,1,0,1,0,0,0,0,0,0,0,0,0,0,0,0,0,0,0
,,,,,,,,,,,,,,,,,,,,,,,
,,,,,,,,,,,,,,,,,,,,,,,
,Montana,All Ethnicities,345,202,143,323,195,128,190,176,14,125,125,0,87,87,0,43,42,1,3,3,0
,,White,306,179,127,284,172,112,170,156,14,115,115,0,77,77,0,38,37,1,3,3,0
,,Black,4,3,1,4,3,1,3,3,0,1,1,0,2,2,0,1,1,0,0,0,0
,,Hispanic,7,4,3,7,4,3,3,3,0,2,2,0,2,2,0,2,2,0,0,0,0
,,Asian,2,2,0,2,2,0,2,2,0,2,2,0,1,1,0,0,0,0,0,0,0
,,American Indian/Alaska Native,25,13,12,25,13,12,11,11,0,5,5,0,4,4,0,2,2,0,0,0,0
,,Multiracial,1,1,0,1,1,0,1,1,0,0,0,0,1,1,0,0,0,0,0,0,0
,Nebraska,All Ethnicities,648,363,285,615,353,262,342,321,21,215,215,0,178,178,0,105,103,2,8,8,0
,,White,553,309,244,521,300,221,294,273,21,179,179,0,158,158,0,88,86,2,8,8,0
,,Black,41,27,14,40,26,14,25,25,0,18,18,0,14,14,0,9,9,0,0,0,0
,,Hispanic,45,20,25,45,20,25,17,17,0,14,14,0,3,3,0,5,5,0,0,0,0
,,Asian,4,3,1,4,3,1,3,3,0,1,1,0,2,2,0,3,3,0,0,0,0
,,American Indian/Alaska Native,3,3,0,3,3,0,2,2,0,2,2,0,1,1,0,0,0,0,0,0,0
,,Multiracial,2,1,1,2,1,1,1,1,0,1,1,0,0,0,0,0,0,0,0,0,0
,Nevada,All Ethnicities,872,528,344,818,499,319,477,457,20,299,299,0,171,171,0,145,140,5,3,3,0
,,White,574,360,214,548,349,199,327,315,12,203,203,0,113,113,0,78,75,3,2,2,0
,,Black,71,38,33,65,32,33,29,29,0,22,22,0,13,13,0,16,16,0,1,1,0
,,Hispanic,166,105,61,150,96,54,97,91,6,63,63,0,35,35,0,39,38,1,0,0,0
,,Asian,35,15,20,32,13,19,12,12,0,5,5,0,6,6,0,8,7,1,0,0,0
,,American Indian/Alaska Native,3,1,2,2,1,1,2,1,1,1,1,0,1,1,0,0,0,0,0,0,0
,,Pacific Islander,10,5,5,10,5,5,5,5,0,4,4,0,2,2,0,2,2,0,0,0,0
,,Multiracial,13,4,9,11,3,8,5,4,1,1,1,0,1,1,0,2,2,0,0,0,0
,New Hampshire,All Ethnicities,406,204,202,374,194,180,189,168,21,107,107,0,71,71,0,46,45,1,2,2,0
,,White,384,191,193,354,183,171,177,156,21,97,97,0,65,65,0,40,39,1,2,2,0
,,Black,6,5,1,4,3,1,5,5,0,4,4,0,3,3,0,0,0,0,0,0,0
,,Hispanic,12,5,7,12,5,7,5,5,0,3,3,0,2,2,0,3,3,0,0,0,0
,,Asian,3,2,1,3,2,1,1,1,0,2,2,0,0,0,0,2,2,0,0,0,0
,,Multiracial,1,1,0,1,1,0,1,1,0,1,1,0,1,1,0,1,1,0,0,0,0
,New Jersey,All Ethnicities,3030,1413,1617,2851,1348,1503,1292,1179,113,780,780,0,560,560,0,332,331,1,6,6,0
,,White,1715,854,861,1589,818,771,792,703,89,449,449,0,308,308,0,185,184,1,3,3,0
,,Black,573,246,327,559,233,326,218,217,1,138,138,0,102,102,0,65,65,0,2,2,0
,,Hispanic,612,269,343,578,254,324,240,221,19,169,169,0,131,131,0,69,69,0,1,1,0
,,Unknown,2,2,0,2,2,0,2,2,0,2,2,0,2,2,0,1,1,0,0,0,0
,,Asian,103,35,68,98,34,64,33,29,4,17,17,0,14,14,0,9,9,0,0,0,0
,,American Indian/Alaska Native,2,1,1,2,1,1,1,1,0,0,0,0,0,0,0,1,1,0,0,0,0
,,Pacific Islander,5,0,5,5,0,5,0,0,0,0,0,0,0,0,0,0,0,0,0,0,0
,,Multiracial,18,6,12,18,6,12,6,6,0,5,5,0,3,3,0,2,2,0,0,0,0
,New Mexico,All Ethnicities,771,514,257,740,492,248,432,423,9,274,274,0,123,123,0,101,101,0,7,7,0
,,White,337,230,107,323,220,103,194,190,4,118,118,0,56,56,0,49,49,0,2,2,0
,,Black,14,10,4,14,10,4,9,9,0,8,8,0,4,4,0,2,2,0,0,0,0
,,Hispanic,378,254,124,362,242,120,213,209,4,138,138,0,59,59,0,47,47,0,5,5,0
,,,,,,,,,,,,,,,,,,,,,,,
,,,,,,,,,,,,,,,,,,,,,,,
,,Asian,3,2,1,3,2,1,2,2,0,2,2,0,0,0,0,0,0,0,0,0,0
,,American Indian/Alaska Native,31,17,14,30,17,13,13,12,1,7,7,0,4,4,0,3,3,0,0,0,0
,,Multiracial,8,1,7,8,1,7,1,1,0,1,1,0,0,0,0,0,0,0,0,0,0
,New York,All Ethnicities,6530,2617,3913,5925,2458,3467,2637,2198,439,1424,1424,0,880,880,0,448,441,7,23,23,0
,,White,3520,1548,1972,3160,1463,1697,1542,1274,268,778,778,0,493,493,0,247,240,7,14,14,0
,,Black,1230,465,765,1164,433,731,443,409,34,279,279,0,175,175,0,88,88,0,5,5,0
,,Hispanic,1449,516,933,1313,480,833,543,443,100,318,318,0,171,171,0,98,98,0,1,1,0
,,Unknown,1,0,1,1,0,1,0,0,0,0,0,0,0,0,0,0,0,0,0,0,0
,,Asian,211,42,169,187,41,146,57,34,23,20,20,0,20,20,0,6,6,0,2,2,0
,,American Indian/Alaska Native,14,5,9,12,5,7,5,3,2,3,3,0,1,1,0,1,1,0,0,0,0
,,Pacific Islander,9,1,8,8,1,7,2,1,1,0,0,0,1,1,0,0,0,0,0,0,0
,,Multiracial,96,40,56,80,35,45,45,34,11,26,26,0,19,19,0,8,8,0,1,1,0
,North Carolina,All Ethnicities,3207,1883,1324,3040,1784,1256,1670,1602,68,1088,1088,0,802,802,0,571,571,0,26,26,0
,,White,2172,1337,835,2057,1272,785,1176,1126,50,760,760,0,565,565,0,364,364,0,14,14,0
,,Black,800,410,390,766,385,381,368,359,9,244,244,0,177,177,0,162,162,0,9,9,0
,,Hispanic,158,108,50,149,102,47,96,93,3,67,67,0,47,47,0,36,36,0,2,2,0
,,Unknown,1,1,0,1,1,0,1,1,0,1,1,0,1,1,0,0,0,0,0,0,0
,,Asian,19,6,13,16,6,10,7,4,3,3,3,0,2,2,0,2,2,0,0,0,0
,,American Indian/Alaska Native,39,18,21,34,15,19,18,16,2,11,11,0,9,9,0,5,5,0,1,1,0
,,Pacific Islander,2,1,1,2,1,1,1,1,0,1,1,0,0,0,0,1,1,0,0,0,0
,,Multiracial,16,2,14,15,2,13,3,2,1,1,1,0,1,1,0,1,1,0,0,0,0
,North Dakota,All Ethnicities,310,136,174,299,132,167,128,121,7,74,74,0,77,77,0,34,34,0,2,2,0
,,White,253,122,131,242,118,124,115,108,7,65,65,0,73,73,0,28,28,0,2,2,0
,,Black,5,3,2,5,3,2,3,3,0,2,2,0,0,0,0,3,3,0,0,0,0
,,Hispanic,8,3,5,8,3,5,3,3,0,2,2,0,1,1,0,0,0,0,0,0,0
,,Asian,2,1,1,2,1,1,1,1,0,0,0,0,0,0,0,0,0,0,0,0,0
,,American Indian/Alaska Native,40,7,33,40,7,33,6,6,0,5,5,0,3,3,0,3,3,0,0,0,0
,,Pacific Islander,1,0,1,1,0,1,0,0,0,0,0,0,0,0,0,0,0,0,0,0,0
,,Multiracial,1,0,1,1,0,1,0,0,0,0,0,0,0,0,0,0,0,0,0,0,0
,Ohio,All Ethnicities,4956,2655,2301,4702,2516,2186,2366,2253,113,1364,1364,0,1183,1182,1,699,698,1,49,49,0
,,White,4010,2167,1843,3792,2057,1735,1934,1828,106,1093,1093,0,943,942,1,527,526,1,42,42,0
,,Black,785,418,367,755,393,362,373,368,5,237,237,0,207,207,0,152,152,0,4,4,0
,,Hispanic,97,50,47,93,48,45,44,42,2,25,25,0,22,22,0,15,15,0,2,2,0
,,Unknown,1,0,1,1,0,1,0,0,0,0,0,0,0,0,0,0,0,0,0,0,0
,,Asian,37,15,22,36,14,22,10,10,0,7,7,0,8,8,0,3,3,0,1,1,0
,,American Indian/Alaska Native,2,1,1,1,0,1,1,1,0,0,0,0,0,0,0,0,0,0,0,0,0
,,Pacific Islander,2,0,2,2,0,2,0,0,0,0,0,0,0,0,0,0,0,0,0,0,0
,,Multiracial,22,4,18,22,4,18,4,4,0,2,2,0,3,3,0,2,2,0,0,0,0
,Oklahoma,All Ethnicities,1288,901,387,1220,850,370,773,759,14,487,487,0,230,230,0,221,218,3,4,4,0
,,White,1002,705,297,948,664,284,597,587,10,381,381,0,175,175,0,162,159,3,4,4,0
,,Black,128,95,33,123,91,32,84,83,1,50,50,0,25,25,0,32,32,0,0,0,0
,,,,,,,,,,,,,,,,,,,,,,,
,,,,,,,,,,,,,,,,,,,,,,,
,,Hispanic,83,53,30,77,49,28,48,46,2,28,28,0,16,16,0,17,17,0,0,0,0
,,Asian,9,8,1,9,8,1,7,7,0,3,3,0,1,1,0,0,0,0,0,0,0
,,American Indian/Alaska Native,56,36,20,53,34,19,33,32,1,22,22,0,10,10,0,9,9,0,0,0,0
,,Pacific Islander,5,2,3,5,2,3,2,2,0,2,2,0,1,1,0,1,1,0,0,0,0
,,Multiracial,5,2,3,5,2,3,2,2,0,1,1,0,2,2,0,0,0,0,0,0,0
,Oregon,All Ethnicities,1111,606,505,1069,591,478,538,515,23,325,323,2,218,218,0,119,117,2,0,0,0
,,White,949,522,427,910,509,401,466,444,22,274,272,2,190,190,0,94,92,2,0,0,0
,,Black,26,17,9,26,17,9,17,17,0,13,13,0,4,4,0,4,4,0,0,0,0
,,Hispanic,87,48,39,86,47,39,38,38,0,26,26,0,20,20,0,16,16,0,0,0,0
,,Asian,30,10,20,30,10,20,8,8,0,5,5,0,4,4,0,1,1,0,0,0,0
,,American Indian/Alaska Native,3,1,2,3,1,2,1,1,0,1,1,0,0,0,0,0,0,0,0,0,0
,,Pacific Islander,8,5,3,7,4,3,4,4,0,3,3,0,0,0,0,2,2,0,0,0,0
,,Multiracial,8,3,5,7,3,4,4,3,1,3,3,0,0,0,0,2,2,0,0,0,0
,Pennsylvania,All Ethnicities,5494,3285,2209,5087,3152,1935,3087,2821,266,1753,1753,0,1342,1339,3,984,979,5,62,61,1
,,White,4314,2570,1744,3962,2470,1492,2466,2220,246,1376,1376,0,1042,1039,3,730,727,3,52,51,1
,,Black,770,480,290,739,457,282,407,399,8,250,250,0,208,208,0,172,172,0,8,8,0
,,Hispanic,311,193,118,290,183,107,174,165,9,106,106,0,78,78,0,69,67,2,2,2,0
,,Unknown,1,1,0,1,1,0,1,1,0,0,0,0,0,0,0,0,0,0,0,0,0
,,Asian,72,31,41,70,31,39,29,27,2,13,13,0,10,10,0,9,9,0,0,0,0
,,American Indian/Alaska Native,4,1,3,4,1,3,0,0,0,1,1,0,0,0,0,0,0,0,0,0,0
,,Pacific Islander,3,0,3,3,0,3,0,0,0,0,0,0,0,0,0,0,0,0,0,0,0
,,Multiracial,19,9,10,18,9,9,10,9,1,7,7,0,4,4,0,4,4,0,0,0,0
,Puerto Rico,All Ethnicities,874,508,366,824,485,339,475,448,27,238,238,0,173,173,0,123,123,0,16,16,0
,,White,22,4,18,21,3,18,3,3,0,2,2,0,0,0,0,0,0,0,0,0,0
,,Black,2,0,2,2,0,2,0,0,0,0,0,0,0,0,0,0,0,0,0,0,0
,,Hispanic,648,316,332,605,300,305,292,265,27,153,153,0,88,88,0,49,49,0,11,11,0
,,Multiracial,202,188,14,196,182,14,180,180,0,83,83,0,85,85,0,74,74,0,5,5,0
,Rhode Island,All Ethnicities,373,148,225,344,139,205,118,101,17,80,80,0,45,45,0,25,22,3,2,2,0
,,White,285,120,165,260,112,148,95,81,14,65,65,0,37,37,0,22,19,3,1,1,0
,,Black,22,6,16,22,6,16,3,3,0,3,3,0,0,0,0,0,0,0,0,0,0
,,Hispanic,50,17,33,46,16,30,18,15,3,12,12,0,7,7,0,3,3,0,1,1,0
,,Asian,10,4,6,10,4,6,2,2,0,0,0,0,1,1,0,0,0,0,0,0,0
,,American Indian/Alaska Native,4,0,4,4,0,4,0,0,0,0,0,0,0,0,0,0,0,0,0,0,0
,,Pacific Islander,1,0,1,1,0,1,0,0,0,0,0,0,0,0,0,0,0,0,0,0,0
,,Multiracial,1,1,0,1,1,0,0,0,0,0,0,0,0,0,0,0,0,0,0,0,0
,South Carolina,All Ethnicities,1615,1035,580,1556,994,562,931,915,16,646,646,0,419,419,0,316,314,2,7,7,0
,,White,1124,753,371,1093,733,360,672,663,9,477,477,0,305,305,0,201,199,2,6,6,0
,,Black,416,230,186,393,212,181,209,204,5,133,133,0,94,94,0,94,94,0,1,1,0
,,Hispanic,54,42,12,51,40,11,40,39,1,30,30,0,17,17,0,16,16,0,0,0,0
,,Unknown,1,0,1,1,0,1,0,0,0,0,0,0,0,0,0,0,0,0,0,0,0
,,Asian,10,5,5,9,5,4,5,4,1,3,3,0,2,2,0,3,3,0,0,0,0
,,,,,,,,,,,,,,,,,,,,,,,
,,,,,,,,,,,,,,,,,,,,,,,
,,American Indian/Alaska Native,3,1,2,3,1,2,1,1,0,1,1,0,1,1,0,1,1,0,0,0,0
,,Pacific Islander,1,0,1,1,0,1,0,0,0,0,0,0,0,0,0,0,0,0,0,0,0
,,Multiracial,6,4,2,5,3,2,4,4,0,2,2,0,0,0,0,1,1,0,0,0,0
,South Dakota,All Ethnicities,310,161,149,298,158,140,152,143,9,91,91,0,98,98,0,46,46,0,3,3,0
,,White,263,137,126,253,134,119,127,120,7,77,77,0,80,80,0,37,37,0,3,3,0
,,Black,1,1,0,1,1,0,1,1,0,1,1,0,1,1,0,1,1,0,0,0,0
,,Hispanic,9,4,5,9,4,5,4,4,0,2,2,0,3,3,0,3,3,0,0,0,0
,,Asian,1,0,1,1,0,1,0,0,0,0,0,0,0,0,0,0,0,0,0,0,0
,,American Indian/Alaska Native,33,18,15,31,18,13,19,17,2,11,11,0,13,13,0,5,5,0,0,0,0
,,Pacific Islander,1,1,0,1,1,0,1,1,0,0,0,0,1,1,0,0,0,0,0,0,0
,,Multiracial,2,0,2,2,0,2,0,0,0,0,0,0,0,0,0,0,0,0,0,0,0
,State unassigned,All Ethnicities,2943,1101,1842,2684,1039,1645,1015,834,181,655,654,1,363,363,0,232,218,14,9,8,1
,,White,1181,508,673,1039,484,555,474,370,104,306,305,1,150,150,0,98,85,13,1,1,0
,,Black,303,121,182,285,114,171,105,94,11,71,71,0,36,36,0,28,28,0,3,3,0
,,Hispanic,1073,388,685,992,360,632,357,306,51,241,241,0,147,147,0,97,96,1,4,3,1
,,Unknown,64,36,28,60,34,26,30,28,2,16,16,0,16,16,0,2,2,0,1,1,0
,,Asian,244,35,209,234,34,200,34,25,9,14,14,0,11,11,0,7,7,0,0,0,0
,,American Indian/Alaska Native,3,1,2,2,1,1,2,1,1,1,1,0,1,1,0,0,0,0,0,0,0
,,Pacific Islander,45,2,43,44,2,42,3,2,1,1,1,0,0,0,0,0,0,0,0,0,0
,,Multiracial,30,10,20,28,10,18,10,8,2,5,5,0,2,2,0,0,0,0,0,0,0
,Tennessee,All Ethnicities,2642,1567,1075,2532,1492,1040,1400,1368,32,959,959,0,584,584,0,439,436,3,32,32,0
,,White,2027,1258,769,1941,1200,741,1120,1094,26,761,761,0,450,450,0,333,331,2,23,23,0
,,Black,499,241,258,481,228,253,218,214,4,151,151,0,102,102,0,85,84,1,5,5,0
,,Hispanic,88,54,34,84,51,33,52,51,1,38,38,0,27,27,0,18,18,0,3,3,0
,,Asian,18,7,11,18,7,11,4,4,0,5,5,0,3,3,0,1,1,0,0,0,0
,,American Indian/Alaska Native,3,3,0,3,3,0,2,2,0,2,2,0,1,1,0,0,0,0,0,0,0
,,Pacific Islander,1,1,0,1,1,0,1,1,0,1,1,0,1,1,0,1,1,0,1,1,0
,,Multiracial,6,3,3,4,2,2,3,2,1,1,1,0,0,0,0,1,1,0,0,0,0
,Texas,All Ethnicities,9071,5211,3860,8692,4977,3715,4569,4436,133,3264,3263,1,1505,1504,1,1596,1586,10,35,34,1
,,White,4523,2887,1636,4310,2763,1547,2528,2447,81,1814,1813,1,840,839,1,780,774,6,14,14,0
,,Black,1147,671,476,1105,634,471,599,594,5,424,424,0,223,223,0,258,258,0,7,7,0
,,Hispanic,3175,1560,1615,3070,1494,1576,1347,1312,35,978,978,0,418,418,0,527,523,4,14,13,1
,,Unknown,5,2,3,5,2,3,1,1,0,1,1,0,0,0,0,0,0,0,0,0,0
,,Asian,156,74,82,146,68,78,71,67,4,39,39,0,21,21,0,25,25,0,0,0,0
,,American Indian/Alaska Native,12,5,7,10,4,6,5,4,1,2,2,0,1,1,0,2,2,0,0,0,0
,,Pacific Islander,16,2,14,16,2,14,2,2,0,1,1,0,0,0,0,1,1,0,0,0,0
,,Multiracial,37,10,27,30,10,20,16,9,7,5,5,0,2,2,0,3,3,0,0,0,0
,Utah,All Ethnicities,1277,593,684,1210,565,645,541,503,38,316,316,0,206,206,0,134,133,1,1,1,0
,,White,1127,535,592,1068,512,556,491,456,35,284,284,0,184,184,0,118,117,1,1,1,0
,,Black,11,7,4,10,6,4,5,5,0,4,4,0,2,2,0,1,1,0,0,0,0
,,Hispanic,94,39,55,91,37,54,34,33,1,23,23,0,17,17,0,13,13,0,0,0,0
,,,,,,,,,,,,,,,,,,,,,,,
,,,,,,,,,,,,,,,,,,,,,,,
,,Asian,15,6,9,13,5,8,5,4,1,2,2,0,3,3,0,0,0,0,0,0,0
,,American Indian/Alaska Native,9,1,8,8,0,8,1,1,0,1,1,0,0,0,0,0,0,0,0,0,0
,,Pacific Islander,11,3,8,10,3,7,4,3,1,2,2,0,0,0,0,2,2,0,0,0,0
,,Multiracial,10,2,8,10,2,8,1,1,0,0,0,0,0,0,0,0,0,0,0,0,0
,Vermont,All Ethnicities,240,123,117,222,120,102,122,107,15,67,67,0,45,45,0,24,24,0,1,1,0
,,White,231,119,112,215,117,98,118,104,14,65,65,0,44,44,0,22,22,0,1,1,0
,,Black,4,3,1,3,2,1,2,2,0,1,1,0,1,1,0,1,1,0,0,0,0
,,Hispanic,4,1,3,4,1,3,1,1,0,1,1,0,0,0,0,1,1,0,0,0,0
,,Asian,1,0,1,0,0,0,1,0,1,0,0,0,0,0,0,0,0,0,0,0,0
,Virginia,All Ethnicities,2920,1388,1532,2739,1330,1409,1322,1202,120,797,797,0,497,496,1,370,370,0,18,15,3
,,White,1940,1010,930,1792,967,825,975,871,104,589,589,0,356,356,0,249,249,0,13,12,1
,,Black,705,283,422,682,271,411,257,247,10,157,157,0,90,90,0,87,87,0,2,1,1
,,Hispanic,162,60,102,156,58,98,56,53,3,32,32,0,34,33,1,21,21,0,2,1,1
,,Asian,91,28,63,87,27,60,27,24,3,16,16,0,14,14,0,10,10,0,1,1,0
,,American Indian/Alaska Native,6,3,3,6,3,3,3,3,0,1,1,0,1,1,0,2,2,0,0,0,0
,,Pacific Islander,4,0,4,4,0,4,0,0,0,0,0,0,0,0,0,0,0,0,0,0,0
,,Multiracial,12,4,8,12,4,8,4,4,0,2,2,0,2,2,0,1,1,0,0,0,0
,Washington,All Ethnicities,1891,1062,829,1822,1036,786,939,902,37,552,551,1,385,385,0,275,270,5,3,3,0
,,White,1502,862,640,1443,841,602,767,735,32,437,436,1,319,319,0,215,210,5,3,3,0
,,Black,98,51,47,96,51,45,46,44,2,32,32,0,21,21,0,18,18,0,0,0,0
,,Hispanic,151,81,70,148,78,70,67,67,0,44,44,0,25,25,0,18,18,0,0,0,0
,,Unknown,3,2,1,3,2,1,2,2,0,1,1,0,1,1,0,0,0,0,0,0,0
,,Asian,74,32,42,71,31,40,29,27,2,20,20,0,11,11,0,13,13,0,0,0,0
,,American Indian/Alaska Native,25,17,8,25,17,8,14,14,0,11,11,0,4,4,0,8,8,0,0,0,0
,,Pacific Islander,17,8,9,17,8,9,7,7,0,3,3,0,2,2,0,0,0,0,0,0,0
,,Multiracial,21,9,12,19,8,11,7,6,1,4,4,0,2,2,0,3,3,0,0,0,0
,West Virginia,All Ethnicities,730,457,273,664,433,231,454,414,40,243,243,0,184,184,0,122,120,2,17,17,0
,,White,682,427,255,621,406,215,424,386,38,222,222,0,172,172,0,108,106,2,17,17,0
,,Black,34,22,12,31,19,12,20,20,0,14,14,0,6,6,0,9,9,0,0,0,0
,,Hispanic,8,6,2,7,6,1,7,6,1,5,5,0,5,5,0,3,3,0,0,0,0
,,Asian,5,2,3,4,2,2,3,2,1,2,2,0,1,1,0,2,2,0,0,0,0
,,Multiracial,1,0,1,1,0,1,0,0,0,0,0,0,0,0,0,0,0,0,0,0,0
,Wisconsin,All Ethnicities,2535,1408,1127,2439,1355,1084,1256,1217,39,756,756,0,846,844,2,367,364,3,7,7,0
,,White,2139,1183,956,2057,1140,917,1055,1020,35,633,633,0,732,730,2,299,296,3,7,7,0
,,Black,210,135,75,201,127,74,126,125,1,75,75,0,65,65,0,42,42,0,0,0,0
,,Hispanic,120,71,49,117,69,48,58,57,1,40,40,0,39,39,0,22,22,0,0,0,0
,,Unknown,2,0,2,2,0,2,0,0,0,0,0,0,0,0,0,0,0,0,0,0,0
,,Asian,30,11,19,29,11,18,9,8,1,4,4,0,6,6,0,1,1,0,0,0,0
,,American Indian/Alaska Native,25,6,19,24,6,18,6,5,1,3,3,0,3,3,0,2,2,0,0,0,0
,,Pacific Islander,2,1,1,2,1,1,1,1,0,1,1,0,1,1,0,1,1,0,0,0,0
,,Multiracial,7,1,6,7,1,6,1,1,0,0,0,0,0,0,0,0,0,0,0,0,0
,,,,,,,,,,,,,,,,,,,,,,,
,,,,,,,,,,,,,,,,,,,,,,,
,Wyoming,All Ethnicities,235,151,84,223,147,76,138,131,7,93,93,0,62,62,0,38,37,1,1,1,0
,,White,217,140,77,205,136,69,127,120,7,83,83,0,58,58,0,36,35,1,1,1,0
,,Black,4,4,0,4,4,0,4,4,0,4,4,0,0,0,0,1,1,0,0,0,0
,,Hispanic,8,5,3,8,5,3,5,5,0,4,4,0,3,3,0,1,1,0,0,0,0
,,Asian,2,0,2,2,0,2,0,0,0,0,0,0,0,0,0,0,0,0,0,0,0
,,American Indian/Alaska Native,4,2,2,4,2,2,2,2,0,2,2,0,1,1,0,0,0,0,0,0,0
35-49 Years,All Donor States of Residence,All Ethnicities,128971,57545,71426,121511,53144,68367,48171,45397,2774,19823,19805,18,10264,10231,33,10568,10317,251,297,288,9
,,White,92417,40868,51549,87431,38388,49043,34126,31877,2249,14586,14568,18,8013,7986,27,7094,6867,227,213,207,6
,,Black,15762,7806,7956,14413,6591,7822,6728,6599,129,2159,2159,0,1053,1049,4,1658,1655,3,38,37,1
,,Hispanic,15414,6726,8688,14545,6164,8381,5472,5181,291,2504,2504,0,889,888,1,1338,1324,14,35,33,2
,,Unknown,99,57,42,96,54,42,40,40,0,30,30,0,15,14,1,8,8,0,0,0,0
,,Asian,3398,1317,2081,3231,1234,1997,1168,1090,78,348,348,0,208,208,0,357,351,6,7,7,0
,,American Indian/Alaska Native,606,228,378,590,214,376,164,162,2,75,75,0,25,25,0,31,31,0,1,1,0
,,Pacific Islander,466,165,301,446,151,295,140,135,5,32,32,0,19,19,0,21,20,1,1,1,0
,,Multiracial,809,378,431,759,348,411,333,313,20,89,89,0,42,42,0,61,61,0,2,2,0
,Alabama,All Ethnicities,2045,903,1142,1969,837,1132,726,719,7,236,236,0,78,78,0,128,125,3,2,2,0
,,White,1539,668,871,1491,629,862,527,521,6,180,180,0,64,64,0,94,91,3,2,2,0
,,Black,458,211,247,432,186,246,182,181,1,46,46,0,12,12,0,27,27,0,0,0,0
,,Hispanic,26,12,14,24,10,14,9,9,0,6,6,0,2,2,0,4,4,0,0,0,0
,,Asian,12,7,5,12,7,5,4,4,0,2,2,0,0,0,0,1,1,0,0,0,0
,,American Indian/Alaska Native,2,0,2,2,0,2,0,0,0,0,0,0,0,0,0,0,0,0,0,0,0
,,Multiracial,8,5,3,8,5,3,4,4,0,2,2,0,0,0,0,2,2,0,0,0,0
,Alaska,All Ethnicities,363,187,176,356,183,173,134,133,1,48,47,1,24,24,0,37,36,1,0,0,0
,,White,285,135,150,278,131,147,96,95,1,37,36,1,19,19,0,28,27,1,0,0,0
,,Black,12,5,7,12,5,7,5,5,0,1,1,0,0,0,0,1,1,0,0,0,0
,,Hispanic,7,3,4,7,3,4,2,2,0,2,2,0,0,0,0,0,0,0,0,0,0
,,Asian,10,9,1,10,9,1,7,7,0,1,1,0,0,0,0,5,5,0,0,0,0
,,American Indian/Alaska Native,45,33,12,45,33,12,22,22,0,7,7,0,5,5,0,2,2,0,0,0,0
,,Pacific Islander,2,1,1,2,1,1,1,1,0,0,0,0,0,0,0,1,1,0,0,0,0
,,Multiracial,2,1,1,2,1,1,1,1,0,0,0,0,0,0,0,0,0,0,0,0,0
,Arizona,All Ethnicities,2292,946,1346,2169,905,1264,822,760,62,320,319,1,125,125,0,202,183,19,3,3,0
,,White,1588,665,923,1491,639,852,589,536,53,223,222,1,95,95,0,144,127,17,3,3,0
,,Black,107,48,59,101,43,58,46,45,1,11,11,0,4,4,0,12,12,0,0,0,0
,,Hispanic,468,201,267,448,191,257,165,157,8,76,76,0,22,22,0,38,36,2,0,0,0
,,Unknown,1,1,0,1,1,0,1,1,0,0,0,0,1,1,0,0,0,0,0,0,0
,,Asian,44,7,37,44,7,37,7,7,0,3,3,0,2,2,0,3,3,0,0,0,0
,,American Indian/Alaska Native,67,19,48,67,19,48,11,11,0,6,6,0,1,1,0,4,4,0,0,0,0
,,Pacific Islander,4,2,2,4,2,2,1,1,0,0,0,0,0,0,0,0,0,0,0,0,0
,,Multiracial,13,3,10,13,3,10,2,2,0,1,1,0,0,0,0,1,1,0,0,0,0
,Arkansas,All Ethnicities,1010,549,461,967,517,450,461,455,6,168,168,0,77,76,1,72,68,4,5,5,0
,,White,827,445,382,798,427,371,368,362,6,142,142,0,67,66,1,55,51,4,4,4,0
,,,,,,,,,,,,,,,,,,,,,,,
,,,,,,,,,,,,,,,,,,,,,,,
,,Black,138,74,64,126,62,64,69,69,0,18,18,0,6,6,0,13,13,0,1,1,0
,,Hispanic,23,17,6,21,15,6,11,11,0,3,3,0,3,3,0,1,1,0,0,0,0
,,Asian,13,8,5,13,8,5,8,8,0,4,4,0,1,1,0,3,3,0,0,0,0
,,American Indian/Alaska Native,1,1,0,1,1,0,1,1,0,0,0,0,0,0,0,0,0,0,0,0,0
,,Pacific Islander,6,4,2,6,4,2,4,4,0,1,1,0,0,0,0,0,0,0,0,0,0
,,Multiracial,2,0,2,2,0,2,0,0,0,0,0,0,0,0,0,0,0,0,0,0,0
,California,All Ethnicities,13181,5987,7194,12409,5606,6803,5052,4729,323,2183,2180,3,893,892,1,1257,1193,64,8,8,0
,,White,6994,3149,3845,6584,2986,3598,2669,2481,188,1222,1219,3,524,524,0,587,531,56,5,5,0
,,Black,977,492,485,914,439,475,431,422,9,144,144,0,59,58,1,103,103,0,0,0,0
,,Hispanic,3871,1791,2080,3634,1655,1979,1450,1355,95,675,675,0,234,234,0,421,415,6,2,2,0
,,Unknown,2,2,0,2,2,0,2,2,0,1,1,0,1,1,0,1,1,0,0,0,0
,,Asian,1019,436,583,966,412,554,400,373,27,109,109,0,58,58,0,128,126,2,0,0,0
,,American Indian/Alaska Native,34,17,17,33,16,17,12,12,0,6,6,0,2,2,0,3,3,0,0,0,0
,,Pacific Islander,149,34,115,147,33,114,28,27,1,7,7,0,4,4,0,4,4,0,0,0,0
,,Multiracial,135,66,69,129,63,66,60,57,3,19,19,0,11,11,0,10,10,0,1,1,0
,Colorado,All Ethnicities,2082,820,1262,1955,765,1190,732,661,71,326,326,0,176,176,0,128,127,1,6,6,0
,,White,1662,642,1020,1563,605,958,568,507,61,264,264,0,145,145,0,102,101,1,5,5,0
,,Black,86,43,43,77,35,42,43,42,1,14,14,0,8,8,0,7,7,0,0,0,0
,,Hispanic,289,114,175,273,106,167,102,94,8,41,41,0,22,22,0,14,14,0,1,1,0
,,Unknown,1,0,1,1,0,1,0,0,0,0,0,0,0,0,0,0,0,0,0,0,0
,,Asian,31,17,14,29,16,13,17,16,1,5,5,0,1,1,0,4,4,0,0,0,0
,,American Indian/Alaska Native,5,3,2,4,2,2,1,1,0,2,2,0,0,0,0,1,1,0,0,0,0
,,Pacific Islander,4,1,3,4,1,3,1,1,0,0,0,0,0,0,0,0,0,0,0,0,0
,,Multiracial,4,0,4,4,0,4,0,0,0,0,0,0,0,0,0,0,0,0,0,0,0
,Connecticut,All Ethnicities,1426,566,860,1346,535,811,491,443,48,228,228,0,92,91,1,83,82,1,1,1,0
,,White,1091,413,678,1027,398,629,361,313,48,166,166,0,72,71,1,57,56,1,1,1,0
,,Black,143,65,78,138,60,78,55,55,0,21,21,0,10,10,0,10,10,0,0,0,0
,,Hispanic,160,78,82,150,68,82,67,67,0,39,39,0,9,9,0,14,14,0,0,0,0
,,Asian,20,6,14,20,6,14,5,5,0,1,1,0,1,1,0,1,1,0,0,0,0
,,American Indian/Alaska Native,1,1,0,1,1,0,0,0,0,0,0,0,0,0,0,0,0,0,0,0,0
,,Pacific Islander,3,0,3,3,0,3,0,0,0,0,0,0,0,0,0,0,0,0,0,0,0
,,Multiracial,8,3,5,7,2,5,3,3,0,1,1,0,0,0,0,1,1,0,0,0,0
,Delaware,All Ethnicities,506,283,223,468,258,210,242,229,13,103,103,0,48,48,0,74,74,0,6,6,0
,,White,394,223,171,371,209,162,184,175,9,81,81,0,37,37,0,57,57,0,3,3,0
,,Black,90,43,47,78,35,43,43,39,4,15,15,0,8,8,0,12,12,0,3,3,0
,,Hispanic,16,14,2,14,12,2,12,12,0,5,5,0,2,2,0,4,4,0,0,0,0
,,Asian,4,2,2,3,1,2,2,2,0,1,1,0,0,0,0,0,0,0,0,0,0
,,American Indian/Alaska Native,1,0,1,1,0,1,0,0,0,0,0,0,0,0,0,0,0,0,0,0,0
,,Multiracial,1,1,0,1,1,0,1,1,0,1,1,0,1,1,0,1,1,0,0,0,0
,District of Columbia,All Ethnicities,304,138,166,287,125,162,113,109,4,42,42,0,30,30,0,26,26,0,0,0,0
,,White,86,18,68,81,17,64,18,14,4,6,6,0,3,3,0,4,4,0,0,0,0
,,,,,,,,,,,,,,,,,,,,,,,
,,,,,,,,,,,,,,,,,,,,,,,
,,Black,186,108,78,174,96,78,85,85,0,30,30,0,22,22,0,21,21,0,0,0,0
,,Hispanic,20,11,9,20,11,9,9,9,0,5,5,0,5,5,0,1,1,0,0,0,0
,,Asian,8,1,7,8,1,7,1,1,0,1,1,0,0,0,0,0,0,0,0,0,0
,,Pacific Islander,2,0,2,2,0,2,0,0,0,0,0,0,0,0,0,0,0,0,0,0,0
,,Multiracial,2,0,2,2,0,2,0,0,0,0,0,0,0,0,0,0,0,0,0,0,0
,Florida,All Ethnicities,6302,3666,2636,5929,3352,2577,2905,2858,47,1148,1148,0,517,517,0,645,633,12,38,38,0
,,White,4410,2589,1821,4180,2409,1771,2007,1969,38,833,833,0,358,358,0,417,405,12,17,17,0
,,Black,803,467,336,714,379,335,414,413,1,117,117,0,59,59,0,117,117,0,3,3,0
,,Hispanic,951,536,415,906,497,409,426,420,6,175,175,0,86,86,0,93,93,0,17,17,0
,,Unknown,4,3,1,4,3,1,1,1,0,1,1,0,0,0,0,0,0,0,0,0,0
,,Asian,93,48,45,88,45,43,39,37,2,17,17,0,9,9,0,15,15,0,1,1,0
,,American Indian/Alaska Native,11,7,4,11,7,4,6,6,0,2,2,0,2,2,0,1,1,0,0,0,0
,,Pacific Islander,10,6,4,8,4,4,5,5,0,1,1,0,0,0,0,1,1,0,0,0,0
,,Multiracial,20,10,10,18,8,10,7,7,0,2,2,0,3,3,0,1,1,0,0,0,0
,Georgia,All Ethnicities,3521,1682,1839,3252,1449,1803,1410,1378,32,539,538,1,148,148,0,293,290,3,6,6,0
,,White,2322,1046,1276,2181,935,1246,860,834,26,361,360,1,101,101,0,157,154,3,2,2,0
,,Black,974,525,449,860,415,445,462,458,4,134,134,0,33,33,0,108,108,0,2,2,0
,,Hispanic,152,80,72,141,71,70,64,62,2,32,32,0,10,10,0,19,19,0,0,0,0
,,Unknown,2,1,1,2,1,1,1,1,0,0,0,0,0,0,0,0,0,0,0,0,0
,,Asian,55,26,29,52,23,29,20,20,0,10,10,0,4,4,0,7,7,0,2,2,0
,,American Indian/Alaska Native,2,0,2,2,0,2,0,0,0,0,0,0,0,0,0,0,0,0,0,0,0
,,Pacific Islander,4,2,2,4,2,2,2,2,0,2,2,0,0,0,0,2,2,0,0,0,0
,,Multiracial,10,2,8,10,2,8,1,1,0,0,0,0,0,0,0,0,0,0,0,0,0
,Hawaii,All Ethnicities,465,271,194,448,257,191,195,192,3,22,22,0,30,30,0,12,12,0,0,0,0
,,White,153,85,68,149,84,65,54,51,3,10,10,0,10,10,0,4,4,0,0,0,0
,,Black,7,3,4,7,3,4,1,1,0,0,0,0,0,0,0,0,0,0,0,0,0
,,Hispanic,12,5,7,12,5,7,4,4,0,0,0,0,1,1,0,0,0,0,0,0,0
,,Unknown,1,0,1,1,0,1,0,0,0,0,0,0,0,0,0,0,0,0,0,0,0
,,Asian,165,102,63,157,94,63,78,78,0,4,4,0,11,11,0,6,6,0,0,0,0
,,American Indian/Alaska Native,1,1,0,1,1,0,0,0,0,1,1,0,0,0,0,0,0,0,0,0,0
,,Pacific Islander,92,64,28,87,59,28,49,49,0,7,7,0,7,7,0,2,2,0,0,0,0
,,Multiracial,34,11,23,34,11,23,9,9,0,0,0,0,1,1,0,0,0,0,0,0,0
,Idaho,All Ethnicities,585,234,351,556,218,338,195,182,13,77,77,0,40,40,0,36,36,0,0,0,0
,,White,538,214,324,510,199,311,177,164,13,73,73,0,38,38,0,31,31,0,0,0,0
,,Black,3,2,1,3,2,1,2,2,0,0,0,0,0,0,0,1,1,0,0,0,0
,,Hispanic,30,15,15,29,14,15,13,13,0,2,2,0,2,2,0,3,3,0,0,0,0
,,Asian,2,1,1,2,1,1,1,1,0,0,0,0,0,0,0,0,0,0,0,0,0
,,American Indian/Alaska Native,8,1,7,8,1,7,1,1,0,1,1,0,0,0,0,1,1,0,0,0,0
,,Pacific Islander,1,1,0,1,1,0,1,1,0,1,1,0,0,0,0,0,0,0,0,0,0
,,Multiracial,3,0,3,3,0,3,0,0,0,0,0,0,0,0,0,0,0,0,0,0,0
,Illinois,All Ethnicities,5754,2370,3384,5408,2198,3210,1918,1755,163,755,755,0,644,639,5,459,454,5,14,8,6
,,,,,,,,,,,,,,,,,,,,,,,
,,,,,,,,,,,,,,,,,,,,,,,
,,White,3823,1591,2232,3610,1514,2096,1283,1152,131,520,520,0,469,465,4,300,298,2,10,7,3
,,Black,1011,502,509,923,424,499,415,406,9,128,128,0,105,105,0,93,93,0,1,0,1
,,Hispanic,743,215,528,708,204,504,170,151,19,90,90,0,53,52,1,53,50,3,2,0,2
,,Unknown,1,1,0,0,0,0,1,1,0,0,0,0,0,0,0,0,0,0,0,0,0
,,Asian,136,52,84,130,49,81,42,39,3,16,16,0,15,15,0,12,12,0,1,1,0
,,American Indian/Alaska Native,3,2,1,3,2,1,2,2,0,1,1,0,1,1,0,1,1,0,0,0,0
,,Pacific Islander,15,5,10,13,4,9,4,3,1,0,0,0,0,0,0,0,0,0,0,0,0
,,Multiracial,22,2,20,21,1,20,1,1,0,0,0,0,1,1,0,0,0,0,0,0,0
,Indiana,All Ethnicities,2757,1290,1467,2617,1187,1430,1125,1095,30,503,503,0,283,283,0,243,236,7,24,24,0
,,White,2381,1102,1279,2266,1020,1246,955,927,28,434,434,0,247,247,0,204,199,5,20,20,0
,,Black,244,134,110,224,116,108,121,121,0,51,51,0,26,26,0,28,26,2,1,1,0
,,Hispanic,101,40,61,97,37,60,35,34,1,15,15,0,7,7,0,9,9,0,3,3,0
,,Asian,21,11,10,21,11,10,10,10,0,3,3,0,3,3,0,2,2,0,0,0,0
,,American Indian/Alaska Native,1,1,0,1,1,0,1,1,0,0,0,0,0,0,0,0,0,0,0,0,0
,,Pacific Islander,3,1,2,2,1,1,2,1,1,0,0,0,0,0,0,0,0,0,0,0,0
,,Multiracial,6,1,5,6,1,5,1,1,0,0,0,0,0,0,0,0,0,0,0,0,0
,Iowa,All Ethnicities,1337,482,855,1294,460,834,414,397,17,176,176,0,133,132,1,97,93,4,2,2,0
,,White,1261,449,812,1220,429,791,385,368,17,167,167,0,127,126,1,87,83,4,2,2,0
,,Black,29,10,19,28,9,19,9,9,0,4,4,0,1,1,0,1,1,0,0,0,0
,,Hispanic,29,13,16,28,12,16,11,11,0,3,3,0,4,4,0,4,4,0,0,0,0
,,Asian,12,10,2,12,10,2,9,9,0,2,2,0,1,1,0,5,5,0,0,0,0
,,American Indian/Alaska Native,4,0,4,4,0,4,0,0,0,0,0,0,0,0,0,0,0,0,0,0,0
,,Multiracial,2,0,2,2,0,2,0,0,0,0,0,0,0,0,0,0,0,0,0,0,0
,Kansas,All Ethnicities,1121,643,478,1073,611,462,511,498,13,235,235,0,147,147,0,127,124,3,3,3,0
,,White,976,547,429,935,521,414,429,417,12,203,203,0,129,129,0,107,104,3,3,3,0
,,Black,56,37,19,52,33,19,34,34,0,14,14,0,8,8,0,9,9,0,0,0,0
,,Hispanic,71,49,22,68,47,21,39,38,1,14,14,0,8,8,0,9,9,0,0,0,0
,,Asian,8,5,3,8,5,3,5,5,0,2,2,0,1,1,0,1,1,0,0,0,0
,,American Indian/Alaska Native,6,5,1,6,5,1,4,4,0,2,2,0,1,1,0,1,1,0,0,0,0
,,Multiracial,4,0,4,4,0,4,0,0,0,0,0,0,0,0,0,0,0,0,0,0,0
,Kentucky,All Ethnicities,1670,800,870,1597,746,851,665,647,18,268,268,0,139,138,1,146,145,1,1,1,0
,,White,1516,714,802,1452,668,784,594,577,17,242,242,0,125,124,1,126,125,1,1,1,0
,,Black,119,72,47,111,64,47,57,57,0,21,21,0,11,11,0,16,16,0,0,0,0
,,Hispanic,19,8,11,18,8,10,8,7,1,4,4,0,2,2,0,2,2,0,0,0,0
,,Asian,9,4,5,9,4,5,4,4,0,1,1,0,0,0,0,1,1,0,0,0,0
,,Pacific Islander,1,0,1,1,0,1,0,0,0,0,0,0,0,0,0,0,0,0,0,0,0
,,Multiracial,6,2,4,6,2,4,2,2,0,0,0,0,1,1,0,1,1,0,0,0,0
,Louisiana,All Ethnicities,1802,1032,770,1658,897,761,906,898,8,303,303,0,168,168,0,202,202,0,4,3,1
,,White,1210,673,537,1147,615,532,590,586,4,211,211,0,130,130,0,121,121,0,3,2,1
,,Black,527,325,202,453,254,199,288,285,3,77,77,0,35,35,0,74,74,0,1,1,0
,,Hispanic,41,29,12,35,24,11,23,22,1,14,14,0,3,3,0,6,6,0,0,0,0
,,,,,,,,,,,,,,,,,,,,,,,
,,,,,,,,,,,,,,,,,,,,,,,
,,Asian,19,5,14,18,4,14,5,5,0,1,1,0,0,0,0,1,1,0,0,0,0
,,Multiracial,5,0,5,5,0,5,0,0,0,0,0,0,0,0,0,0,0,0,0,0,0
,Maine,All Ethnicities,620,250,370,575,232,343,209,185,24,86,86,0,50,50,0,35,32,3,2,2,0
,,White,597,243,354,554,227,327,203,179,24,84,84,0,48,48,0,34,31,3,2,2,0
,,Black,8,3,5,6,1,5,2,2,0,1,1,0,0,0,0,0,0,0,0,0,0
,,Hispanic,7,1,6,7,1,6,1,1,0,0,0,0,1,1,0,0,0,0,0,0,0
,,Asian,4,2,2,4,2,2,2,2,0,0,0,0,1,1,0,1,1,0,0,0,0
,,American Indian/Alaska Native,1,0,1,1,0,1,0,0,0,0,0,0,0,0,0,0,0,0,0,0,0
,,Multiracial,3,1,2,3,1,2,1,1,0,1,1,0,0,0,0,0,0,0,0,0,0
,Maryland,All Ethnicities,3035,1199,1836,2832,1090,1742,1067,976,91,406,406,0,299,298,1,286,283,3,7,7,0
,,White,1778,715,1063,1649,657,992,629,561,68,255,255,0,183,183,0,148,145,3,5,5,0
,,Black,1040,408,632,975,359,616,365,349,16,126,126,0,93,92,1,112,112,0,2,2,0
,,Hispanic,115,44,71,112,44,68,43,40,3,14,14,0,13,13,0,16,16,0,0,0,0
,,Unknown,1,0,1,1,0,1,0,0,0,0,0,0,0,0,0,0,0,0,0,0,0
,,Asian,72,27,45,66,25,41,27,23,4,10,10,0,9,9,0,10,10,0,0,0,0
,,American Indian/Alaska Native,5,1,4,5,1,4,0,0,0,0,0,0,0,0,0,0,0,0,0,0,0
,,Pacific Islander,13,2,11,13,2,11,2,2,0,1,1,0,1,1,0,0,0,0,0,0,0
,,Multiracial,11,2,9,11,2,9,1,1,0,0,0,0,0,0,0,0,0,0,0,0,0
,Massachusetts,All Ethnicities,2909,1065,1844,2687,994,1693,902,766,136,403,403,0,180,180,0,169,154,15,2,2,0
,,White,2429,865,1564,2238,813,1425,735,611,124,327,327,0,148,148,0,135,120,15,2,2,0
,,Black,153,53,100,141,44,97,42,39,3,23,23,0,8,8,0,13,13,0,0,0,0
,,Hispanic,251,120,131,236,111,125,99,93,6,46,46,0,19,19,0,16,16,0,0,0,0
,,Unknown,1,1,0,1,1,0,0,0,0,0,0,0,0,0,0,0,0,0,0,0,0
,,Asian,59,16,43,55,15,40,17,14,3,3,3,0,4,4,0,5,5,0,0,0,0
,,American Indian/Alaska Native,5,4,1,5,4,1,4,4,0,3,3,0,1,1,0,0,0,0,0,0,0
,,Pacific Islander,1,0,1,1,0,1,0,0,0,0,0,0,0,0,0,0,0,0,0,0,0
,,Multiracial,10,6,4,10,6,4,5,5,0,1,1,0,0,0,0,0,0,0,0,0,0
,Michigan,All Ethnicities,4926,2084,2842,4683,1931,2752,1611,1525,86,671,670,1,317,317,0,448,445,3,12,12,0
,,White,4055,1713,2342,3874,1616,2258,1303,1223,80,571,570,1,276,276,0,349,346,3,11,11,0
,,Black,645,288,357,595,241,354,240,237,3,70,70,0,32,32,0,75,75,0,1,1,0
,,Hispanic,141,52,89,130,44,86,46,43,3,20,20,0,5,5,0,16,16,0,0,0,0
,,Asian,49,19,30,48,18,30,13,13,0,6,6,0,2,2,0,5,5,0,0,0,0
,,American Indian/Alaska Native,15,6,9,15,6,9,4,4,0,1,1,0,1,1,0,1,1,0,0,0,0
,,Pacific Islander,7,3,4,7,3,4,2,2,0,1,1,0,0,0,0,1,1,0,0,0,0
,,Multiracial,14,3,11,14,3,11,3,3,0,2,2,0,1,1,0,1,1,0,0,0,0
,Minnesota,All Ethnicities,3085,877,2208,2938,830,2108,834,741,93,342,341,1,408,398,10,206,201,5,15,15,0
,,White,2815,790,2025,2683,751,1932,750,664,86,313,312,1,381,372,9,188,183,5,15,15,0
,,Black,109,43,66,100,36,64,39,37,2,12,12,0,14,13,1,10,10,0,0,0,0
,,Hispanic,64,23,41,60,23,37,25,21,4,11,11,0,8,8,0,3,3,0,0,0,0
,,Unknown,3,0,3,3,0,3,0,0,0,0,0,0,0,0,0,0,0,0,0,0,0
,,Asian,40,9,31,39,9,30,10,9,1,4,4,0,2,2,0,4,4,0,0,0,0
,,,,,,,,,,,,,,,,,,,,,,,
,,,,,,,,,,,,,,,,,,,,,,,
,,American Indian/Alaska Native,44,10,34,43,9,34,8,8,0,2,2,0,2,2,0,1,1,0,0,0,0
,,Multiracial,10,2,8,10,2,8,2,2,0,0,0,0,1,1,0,0,0,0,0,0,0
,Mississippi,All Ethnicities,1002,532,470,950,494,456,423,409,14,149,149,0,61,61,0,69,69,0,2,2,0
,,White,698,347,351,671,334,337,274,260,14,106,106,0,43,43,0,27,27,0,2,2,0
,,Black,277,171,106,254,148,106,140,140,0,40,40,0,16,16,0,41,41,0,0,0,0
,,Hispanic,12,6,6,10,4,6,4,4,0,1,1,0,1,1,0,0,0,0,0,0,0
,,Asian,10,4,6,10,4,6,3,3,0,1,1,0,0,0,0,1,1,0,0,0,0
,,American Indian/Alaska Native,3,3,0,3,3,0,1,1,0,1,1,0,0,0,0,0,0,0,0,0,0
,,Multiracial,2,1,1,2,1,1,1,1,0,0,0,0,1,1,0,0,0,0,0,0,0
,Missouri,All Ethnicities,2372,1315,1057,2196,1166,1030,1069,1045,24,410,410,0,219,219,0,296,293,3,5,5,0
,,White,1989,1062,927,1877,974,903,857,836,21,340,340,0,198,198,0,231,228,3,3,3,0
,,Black,295,204,91,242,152,90,170,169,1,54,54,0,14,14,0,50,50,0,2,2,0
,,Hispanic,47,30,17,41,26,15,25,23,2,11,11,0,4,4,0,8,8,0,0,0,0
,,Asian,23,11,12,20,8,12,11,11,0,4,4,0,3,3,0,5,5,0,0,0,0
,,American Indian/Alaska Native,7,4,3,6,3,3,3,3,0,1,1,0,0,0,0,1,1,0,0,0,0
,,Pacific Islander,2,1,1,2,1,1,1,1,0,0,0,0,0,0,0,1,1,0,0,0,0
,,Multiracial,9,3,6,8,2,6,2,2,0,0,0,0,0,0,0,0,0,0,0,0,0
,Montana,All Ethnicities,444,173,271,427,165,262,147,139,8,67,66,1,32,32,0,24,24,0,0,0,0
,,White,406,164,242,390,157,233,139,131,8,65,64,1,32,32,0,23,23,0,0,0,0
,,Black,2,1,1,1,0,1,1,1,0,0,0,0,0,0,0,0,0,0,0,0,0
,,Hispanic,6,4,2,6,4,2,4,4,0,1,1,0,0,0,0,1,1,0,0,0,0
,,Asian,1,1,0,1,1,0,1,1,0,0,0,0,0,0,0,0,0,0,0,0,0
,,American Indian/Alaska Native,28,3,25,28,3,25,2,2,0,1,1,0,0,0,0,0,0,0,0,0,0
,,Multiracial,1,0,1,1,0,1,0,0,0,0,0,0,0,0,0,0,0,0,0,0,0
,Nebraska,All Ethnicities,765,302,463,733,287,446,279,265,14,92,92,0,100,100,0,50,47,3,0,0,0
,,White,676,258,418,647,246,401,242,228,14,81,81,0,93,93,0,43,40,3,0,0,0
,,Black,41,21,20,38,18,20,19,19,0,6,6,0,6,6,0,5,5,0,0,0,0
,,Hispanic,32,14,18,32,14,18,12,12,0,4,4,0,0,0,0,1,1,0,0,0,0
,,Asian,8,6,2,8,6,2,4,4,0,0,0,0,1,1,0,1,1,0,0,0,0
,,American Indian/Alaska Native,5,2,3,5,2,3,1,1,0,1,1,0,0,0,0,0,0,0,0,0,0
,,Multiracial,3,1,2,3,1,2,1,1,0,0,0,0,0,0,0,0,0,0,0,0,0
,Nevada,All Ethnicities,933,519,414,881,484,397,431,416,15,191,191,0,60,60,0,103,101,2,0,0,0
,,White,645,351,294,613,330,283,292,282,10,139,139,0,46,46,0,62,61,1,0,0,0
,,Black,87,48,39,82,43,39,44,44,0,8,8,0,7,7,0,9,9,0,0,0,0
,,Hispanic,130,81,49,123,77,46,60,57,3,29,29,0,2,2,0,17,17,0,0,0,0
,,Asian,46,27,19,40,23,17,25,24,1,11,11,0,3,3,0,14,13,1,0,0,0
,,American Indian/Alaska Native,9,3,6,9,3,6,1,1,0,2,2,0,0,0,0,0,0,0,0,0,0
,,Pacific Islander,7,5,2,6,4,2,5,5,0,0,0,0,1,1,0,0,0,0,0,0,0
,,Multiracial,9,4,5,8,4,4,4,3,1,2,2,0,1,1,0,1,1,0,0,0,0
,New Hampshire,All Ethnicities,647,237,410,604,224,380,209,182,27,101,101,0,46,46,0,51,48,3,1,1,0
,,White,609,220,389,570,210,360,195,169,26,93,93,0,43,43,0,47,44,3,1,1,0
,,,,,,,,,,,,,,,,,,,,,,,
,,,,,,,,,,,,,,,,,,,,,,,
,,Black,14,8,6,12,6,6,7,7,0,3,3,0,2,2,0,3,3,0,0,0,0
,,Hispanic,14,4,10,14,4,10,3,3,0,3,3,0,1,1,0,1,1,0,0,0,0
,,Asian,8,4,4,6,3,3,3,2,1,1,1,0,0,0,0,0,0,0,0,0,0
,,Multiracial,2,1,1,2,1,1,1,1,0,1,1,0,0,0,0,0,0,0,0,0,0
,New Jersey,All Ethnicities,3897,1523,2374,3721,1426,2295,1220,1144,76,541,541,0,276,276,0,222,219,3,3,3,0
,,White,2518,966,1552,2407,917,1490,763,703,60,348,348,0,180,180,0,128,126,2,1,1,0
,,Black,577,254,323,544,224,320,208,205,3,76,76,0,50,50,0,36,36,0,1,1,0
,,Hispanic,590,237,353,566,223,343,194,185,9,99,99,0,36,36,0,43,42,1,0,0,0
,,Asian,179,52,127,172,49,123,44,40,4,11,11,0,7,7,0,11,11,0,0,0,0
,,American Indian/Alaska Native,2,0,2,2,0,2,0,0,0,0,0,0,0,0,0,0,0,0,0,0,0
,,Pacific Islander,14,6,8,13,5,8,5,5,0,2,2,0,2,2,0,2,2,0,1,1,0
,,Multiracial,17,8,9,17,8,9,6,6,0,5,5,0,1,1,0,2,2,0,0,0,0
,New Mexico,All Ethnicities,743,351,392,708,334,374,278,260,18,113,113,0,29,29,0,34,34,0,2,2,0
,,White,372,191,181,352,181,171,154,144,10,67,67,0,20,20,0,19,19,0,1,1,0
,,Black,17,8,9,16,7,9,7,7,0,1,1,0,1,1,0,1,1,0,0,0,0
,,Hispanic,311,141,170,299,135,164,107,101,6,44,44,0,8,8,0,12,12,0,1,1,0
,,Asian,7,3,4,7,3,4,3,3,0,0,0,0,0,0,0,1,1,0,0,0,0
,,American Indian/Alaska Native,32,6,26,31,6,25,5,4,1,1,1,0,0,0,0,1,1,0,0,0,0
,,Multiracial,4,2,2,3,2,1,2,1,1,0,0,0,0,0,0,0,0,0,0,0,0
,New York,All Ethnicities,7477,2750,4727,6803,2437,4366,2564,2213,351,977,977,0,445,444,1,305,296,9,17,17,0
,,White,4702,1649,3053,4306,1520,2786,1556,1298,258,607,607,0,290,289,1,192,184,8,7,7,0
,,Black,1091,427,664,978,343,635,395,366,29,126,126,0,57,57,0,42,42,0,4,4,0
,,Hispanic,1340,551,789,1221,469,752,484,448,36,208,208,0,79,79,0,56,55,1,5,5,0
,,Unknown,2,2,0,2,2,0,2,2,0,1,1,0,0,0,0,0,0,0,0,0,0
,,Asian,245,79,166,213,69,144,85,63,22,19,19,0,16,16,0,12,12,0,0,0,0
,,American Indian/Alaska Native,10,3,7,9,2,7,2,2,0,2,2,0,0,0,0,1,1,0,0,0,0
,,Pacific Islander,15,1,14,14,1,13,2,1,1,0,0,0,0,0,0,0,0,0,0,0,0
,,Multiracial,72,38,34,60,31,29,38,33,5,14,14,0,3,3,0,2,2,0,1,1,0
,North Carolina,All Ethnicities,3311,1592,1719,3137,1482,1655,1296,1238,58,631,630,1,333,333,0,346,341,5,11,11,0
,,White,2407,1164,1243,2289,1104,1185,939,887,52,478,477,1,258,258,0,226,221,5,9,9,0
,,Black,714,333,381,662,287,375,280,274,6,113,113,0,59,59,0,88,88,0,2,2,0
,,Hispanic,108,63,45,104,59,45,49,49,0,29,29,0,10,10,0,25,25,0,0,0,0
,,Unknown,1,1,0,1,1,0,1,1,0,0,0,0,0,0,0,0,0,0,0,0,0
,,Asian,36,19,17,36,19,17,17,17,0,8,8,0,6,6,0,5,5,0,0,0,0
,,American Indian/Alaska Native,31,10,21,31,10,21,8,8,0,2,2,0,0,0,0,1,1,0,0,0,0
,,Pacific Islander,2,0,2,2,0,2,0,0,0,0,0,0,0,0,0,0,0,0,0,0,0
,,Multiracial,12,2,10,12,2,10,2,2,0,1,1,0,0,0,0,1,1,0,0,0,0
,North Dakota,All Ethnicities,366,117,249,356,116,240,90,82,8,45,45,0,53,52,1,18,18,0,3,2,1
,,White,331,110,221,321,109,212,86,78,8,41,41,0,49,48,1,17,17,0,2,1,1
,,Black,2,1,1,2,1,1,1,1,0,0,0,0,0,0,0,0,0,0,0,0,0
,,Hispanic,3,1,2,3,1,2,0,0,0,0,0,0,0,0,0,0,0,0,0,0,0
,,,,,,,,,,,,,,,,,,,,,,,
,,,,,,,,,,,,,,,,,,,,,,,
,,Asian,1,0,1,1,0,1,0,0,0,0,0,0,0,0,0,0,0,0,0,0,0
,,American Indian/Alaska Native,28,4,24,28,4,24,2,2,0,3,3,0,3,3,0,1,1,0,1,1,0
,,Multiracial,1,1,0,1,1,0,1,1,0,1,1,0,1,1,0,0,0,0,0,0,0
,Ohio,All Ethnicities,5559,2400,3159,5278,2213,3065,2006,1921,85,818,818,0,601,599,2,468,460,8,11,11,0
,,White,4761,2067,2694,4532,1927,2605,1720,1640,80,715,715,0,521,519,2,385,377,8,9,9,0
,,Black,678,295,383,630,250,380,253,250,3,81,81,0,69,69,0,71,71,0,2,2,0
,,Hispanic,75,25,50,73,25,48,24,22,2,17,17,0,9,9,0,7,7,0,0,0,0
,,Asian,28,11,17,27,10,17,9,9,0,4,4,0,2,2,0,5,5,0,0,0,0
,,American Indian/Alaska Native,1,0,1,1,0,1,0,0,0,0,0,0,0,0,0,0,0,0,0,0,0
,,Multiracial,16,2,14,15,1,14,0,0,0,1,1,0,0,0,0,0,0,0,0,0,0
,Oklahoma,All Ethnicities,1391,818,573,1309,749,560,627,614,13,267,267,0,61,61,0,114,114,0,1,1,0
,,White,1166,692,474,1104,642,462,531,519,12,236,236,0,54,54,0,92,92,0,1,1,0
,,Black,96,51,45,85,40,45,37,37,0,8,8,0,2,2,0,9,9,0,0,0,0
,,Hispanic,41,24,17,39,23,16,18,17,1,8,8,0,5,5,0,7,7,0,0,0,0
,,Asian,10,9,1,10,9,1,7,7,0,4,4,0,0,0,0,1,1,0,0,0,0
,,American Indian/Alaska Native,70,39,31,64,33,31,32,32,0,9,9,0,0,0,0,5,5,0,0,0,0
,,Pacific Islander,1,0,1,1,0,1,0,0,0,0,0,0,0,0,0,0,0,0,0,0,0
,,Multiracial,7,3,4,6,2,4,2,2,0,2,2,0,0,0,0,0,0,0,0,0,0
,Oregon,All Ethnicities,1325,544,781,1285,524,761,442,426,16,210,210,0,85,85,0,76,72,4,1,1,0
,,White,1194,496,698,1157,477,680,400,386,14,185,185,0,77,77,0,64,60,4,1,1,0
,,Black,14,4,10,14,4,10,2,2,0,1,1,0,0,0,0,0,0,0,0,0,0
,,Hispanic,70,27,43,68,27,41,25,23,2,16,16,0,6,6,0,6,6,0,0,0,0
,,Asian,27,12,15,27,12,15,11,11,0,7,7,0,2,2,0,5,5,0,0,0,0
,,American Indian/Alaska Native,5,1,4,5,1,4,0,0,0,0,0,0,0,0,0,0,0,0,0,0,0
,,Pacific Islander,11,4,7,10,3,7,4,4,0,1,1,0,0,0,0,1,1,0,0,0,0
,,Multiracial,4,0,4,4,0,4,0,0,0,0,0,0,0,0,0,0,0,0,0,0,0
,Pennsylvania,All Ethnicities,6462,3226,3236,6009,2997,3012,2816,2596,220,1120,1120,0,645,644,1,592,588,4,25,25,0
,,White,5368,2631,2737,4991,2468,2523,2304,2094,210,919,919,0,567,566,1,469,465,4,23,23,0
,,Black,717,398,319,664,351,313,346,340,6,127,127,0,55,55,0,79,79,0,2,2,0
,,Hispanic,289,163,126,271,147,124,139,137,2,62,62,0,19,19,0,33,33,0,0,0,0
,,Asian,69,26,43,64,23,41,22,20,2,7,7,0,3,3,0,9,9,0,0,0,0
,,American Indian/Alaska Native,3,3,0,3,3,0,3,3,0,3,3,0,1,1,0,1,1,0,0,0,0
,,Pacific Islander,3,0,3,3,0,3,0,0,0,0,0,0,0,0,0,0,0,0,0,0,0
,,Multiracial,13,5,8,13,5,8,2,2,0,2,2,0,0,0,0,1,1,0,0,0,0
,Puerto Rico,All Ethnicities,719,367,352,667,329,338,302,289,13,50,50,0,23,23,0,50,49,1,1,1,0
,,White,23,3,20,21,2,19,2,2,0,0,0,0,0,0,0,1,0,1,0,0,0
,,Black,4,1,3,4,1,3,0,0,0,0,0,0,0,0,0,0,0,0,0,0,0
,,Hispanic,534,211,323,496,186,310,171,158,13,34,34,0,14,14,0,19,19,0,1,1,0
,,Multiracial,158,152,6,146,140,6,129,129,0,16,16,0,9,9,0,30,30,0,0,0,0
,Rhode Island,All Ethnicities,456,144,312,431,135,296,124,109,15,49,49,0,32,32,0,16,15,1,0,0,0
,,White,397,124,273,377,118,259,107,94,13,43,43,0,28,28,0,15,14,1,0,0,0
,,,,,,,,,,,,,,,,,,,,,,,
,,,,,,,,,,,,,,,,,,,,,,,
,,Black,20,7,13,18,6,12,6,5,1,2,2,0,0,0,0,0,0,0,0,0,0
,,Hispanic,33,11,22,31,10,21,9,8,1,3,3,0,3,3,0,1,1,0,0,0,0
,,Asian,3,0,3,3,0,3,0,0,0,0,0,0,0,0,0,0,0,0,0,0,0
,,American Indian/Alaska Native,1,0,1,1,0,1,0,0,0,0,0,0,0,0,0,0,0,0,0,0,0
,,Pacific Islander,2,2,0,1,1,0,2,2,0,1,1,0,1,1,0,0,0,0,0,0,0
,South Carolina,All Ethnicities,1792,1001,791,1695,925,770,865,846,19,367,367,0,147,147,0,197,195,2,1,1,0
,,White,1309,685,624,1247,642,605,593,576,17,278,278,0,118,118,0,106,104,2,1,1,0
,,Black,420,286,134,386,254,132,245,243,2,74,74,0,26,26,0,84,84,0,0,0,0
,,Hispanic,34,21,13,33,20,13,20,20,0,12,12,0,1,1,0,5,5,0,0,0,0
,,Unknown,1,0,1,1,0,1,0,0,0,0,0,0,0,0,0,0,0,0,0,0,0
,,Asian,19,7,12,19,7,12,5,5,0,1,1,0,1,1,0,1,1,0,0,0,0
,,American Indian/Alaska Native,1,0,1,1,0,1,0,0,0,0,0,0,0,0,0,0,0,0,0,0,0
,,Pacific Islander,4,1,3,4,1,3,1,1,0,1,1,0,1,1,0,0,0,0,0,0,0
,,Multiracial,4,1,3,4,1,3,1,1,0,1,1,0,0,0,0,1,1,0,0,0,0
,South Dakota,All Ethnicities,383,138,245,366,128,238,127,120,7,49,49,0,63,62,1,28,28,0,1,1,0
,,White,340,122,218,328,117,211,115,108,7,44,44,0,61,60,1,25,25,0,1,1,0
,,Black,5,4,1,2,1,1,3,3,0,1,1,0,0,0,0,2,2,0,0,0,0
,,Hispanic,8,2,6,7,1,6,2,2,0,0,0,0,1,1,0,0,0,0,0,0,0
,,Asian,1,0,1,1,0,1,0,0,0,0,0,0,0,0,0,0,0,0,0,0,0
,,American Indian/Alaska Native,24,9,15,23,8,15,6,6,0,4,4,0,0,0,0,1,1,0,0,0,0
,,Pacific Islander,1,1,0,1,1,0,1,1,0,0,0,0,1,1,0,0,0,0,0,0,0
,,Multiracial,4,0,4,4,0,4,0,0,0,0,0,0,0,0,0,0,0,0,0,0,0
,State unassigned,All Ethnicities,2709,738,1971,2569,701,1868,602,515,87,297,293,4,141,138,3,107,96,11,2,2,0
,,White,1137,395,742,1060,377,683,316,268,48,160,156,4,74,73,1,48,42,6,0,0,0
,,Black,222,62,160,212,56,156,51,47,4,15,15,0,7,6,1,9,9,0,0,0,0
,,Hispanic,877,203,674,837,192,645,171,143,28,87,87,0,42,42,0,33,32,1,2,2,0
,,Unknown,67,35,32,65,33,32,27,27,0,22,22,0,12,11,1,6,6,0,0,0,0
,,Asian,328,35,293,320,35,285,30,25,5,10,10,0,5,5,0,10,7,3,0,0,0
,,American Indian/Alaska Native,7,1,6,7,1,6,0,0,0,1,1,0,0,0,0,0,0,0,0,0,0
,,Pacific Islander,46,0,46,44,0,44,1,0,1,0,0,0,0,0,0,1,0,1,0,0,0
,,Multiracial,25,7,18,24,7,17,6,5,1,2,2,0,1,1,0,0,0,0,0,0,0
,Tennessee,All Ethnicities,2623,1417,1206,2454,1273,1181,1206,1181,25,544,544,0,246,245,1,255,255,0,14,14,0
,,White,2152,1158,994,2032,1056,976,977,959,18,453,453,0,207,206,1,191,191,0,12,12,0
,,Black,366,200,166,325,164,161,174,169,5,56,56,0,29,29,0,43,43,0,2,2,0
,,Hispanic,75,45,30,67,39,28,42,40,2,29,29,0,7,7,0,16,16,0,0,0,0
,,Unknown,2,1,1,2,1,1,1,1,0,1,1,0,0,0,0,0,0,0,0,0,0
,,Asian,20,9,11,20,9,11,8,8,0,3,3,0,2,2,0,2,2,0,0,0,0
,,American Indian/Alaska Native,1,1,0,1,1,0,1,1,0,0,0,0,0,0,0,0,0,0,0,0,0
,,Pacific Islander,2,2,0,2,2,0,2,2,0,1,1,0,0,0,0,2,2,0,0,0,0
,,Multiracial,5,1,4,5,1,4,1,1,0,1,1,0,1,1,0,1,1,0,0,0,0
,Texas,All Ethnicities,9075,4442,4633,8546,4025,4521,3537,3439,98,1595,1594,1,418,418,0,925,913,12,10,9,1
,,,,,,,,,,,,,,,,,,,,,,,
,,,,,,,,,,,,,,,,,,,,,,,
,,White,5025,2511,2514,4777,2345,2432,1996,1928,68,953,952,1,267,267,0,493,481,12,7,6,1
,,Black,1091,628,463,959,498,461,518,516,2,155,155,0,46,46,0,134,134,0,0,0,0
,,Hispanic,2702,1199,1503,2570,1085,1485,931,913,18,454,454,0,89,89,0,265,265,0,0,0,0
,,Unknown,9,9,0,9,9,0,3,3,0,4,4,0,1,1,0,1,1,0,0,0,0
,,Asian,168,74,94,162,70,92,64,62,2,22,22,0,12,12,0,27,27,0,3,3,0
,,American Indian/Alaska Native,17,5,12,16,4,12,3,3,0,2,2,0,1,1,0,1,1,0,0,0,0
,,Pacific Islander,14,6,8,13,5,8,5,5,0,2,2,0,0,0,0,2,2,0,0,0,0
,,Multiracial,49,10,39,40,9,31,17,9,8,3,3,0,2,2,0,2,2,0,0,0,0
,Utah,All Ethnicities,1170,408,762,1124,385,739,326,308,18,167,166,1,69,69,0,64,60,4,0,0,0
,,White,1045,357,688,1002,336,666,293,275,18,146,145,1,65,65,0,53,50,3,0,0,0
,,Black,6,2,4,5,2,3,2,2,0,0,0,0,1,1,0,2,1,1,0,0,0
,,Hispanic,89,36,53,87,34,53,22,22,0,15,15,0,3,3,0,6,6,0,0,0,0
,,Asian,16,6,10,16,6,10,5,5,0,2,2,0,0,0,0,3,3,0,0,0,0
,,American Indian/Alaska Native,9,6,3,9,6,3,4,4,0,4,4,0,0,0,0,0,0,0,0,0,0
,,Pacific Islander,1,0,1,1,0,1,0,0,0,0,0,0,0,0,0,0,0,0,0,0,0
,,Multiracial,4,1,3,4,1,3,0,0,0,0,0,0,0,0,0,0,0,0,0,0,0
,Vermont,All Ethnicities,278,98,180,259,93,166,83,70,13,28,28,0,22,22,0,18,17,1,0,0,0
,,White,269,95,174,250,90,160,82,69,13,28,28,0,22,22,0,18,17,1,0,0,0
,,Black,5,3,2,5,3,2,1,1,0,0,0,0,0,0,0,0,0,0,0,0,0
,,Hispanic,3,0,3,3,0,3,0,0,0,0,0,0,0,0,0,0,0,0,0,0,0
,,Pacific Islander,1,0,1,1,0,1,0,0,0,0,0,0,0,0,0,0,0,0,0,0,0
,Virginia,All Ethnicities,3577,1300,2277,3377,1230,2147,1166,1045,121,452,452,0,188,188,0,257,248,9,13,13,0
,,White,2449,903,1546,2288,859,1429,831,723,108,324,324,0,132,132,0,159,150,9,6,6,0
,,Black,830,300,530,801,279,522,254,246,8,91,91,0,32,32,0,69,69,0,6,6,0
,,Hispanic,144,52,92,138,50,88,41,37,4,22,22,0,13,13,0,15,15,0,1,1,0
,,Asian,126,40,86,123,37,86,35,35,0,12,12,0,11,11,0,13,13,0,0,0,0
,,American Indian/Alaska Native,6,0,6,6,0,6,0,0,0,0,0,0,0,0,0,0,0,0,0,0,0
,,Pacific Islander,7,3,4,7,3,4,2,2,0,2,2,0,0,0,0,1,1,0,0,0,0
,,Multiracial,15,2,13,14,2,12,3,2,1,1,1,0,0,0,0,0,0,0,0,0,0
,Washington,All Ethnicities,2237,950,1287,2179,918,1261,744,722,22,302,300,2,166,166,0,157,155,2,2,2,0
,,White,1884,798,1086,1835,774,1061,617,596,21,264,262,2,147,147,0,130,128,2,2,2,0
,,Black,64,25,39,62,23,39,23,23,0,5,5,0,2,2,0,4,4,0,0,0,0
,,Hispanic,144,63,81,139,59,80,50,49,1,16,16,0,7,7,0,13,13,0,0,0,0
,,Asian,83,39,44,81,37,44,32,32,0,9,9,0,7,7,0,6,6,0,0,0,0
,,American Indian/Alaska Native,17,7,10,17,7,10,6,6,0,2,2,0,1,1,0,2,2,0,0,0,0
,,Pacific Islander,14,6,8,14,6,8,6,6,0,0,0,0,0,0,0,0,0,0,0,0,0
,,Multiracial,31,12,19,31,12,19,10,10,0,6,6,0,2,2,0,2,2,0,0,0,0
,West Virginia,All Ethnicities,786,409,377,726,381,345,373,342,31,119,119,0,86,85,1,64,64,0,7,7,0
,,White,741,384,357,684,359,325,352,321,31,112,112,0,81,80,1,62,62,0,5,5,0
,,Black,37,21,16,34,18,16,18,18,0,7,7,0,4,4,0,2,2,0,2,2,0
,,Hispanic,6,4,2,6,4,2,3,3,0,0,0,0,1,1,0,0,0,0,0,0,0
,,,,,,,,,,,,,,,,,,,,,,,
,,,,,,,,,,,,,,,,,,,,,,,
,,Asian,2,0,2,2,0,2,0,0,0,0,0,0,0,0,0,0,0,0,0,0,0
,Wisconsin,All Ethnicities,3172,1326,1846,3055,1261,1794,1108,1062,46,456,456,0,555,554,1,240,234,6,3,3,0
,,White,2886,1194,1692,2790,1145,1645,995,954,41,410,410,0,528,527,1,222,216,6,3,3,0
,,Black,144,81,63,131,70,61,72,70,2,31,31,0,14,14,0,12,12,0,0,0,0
,,Hispanic,82,34,48,77,31,46,24,22,2,7,7,0,7,7,0,2,2,0,0,0,0
,,Asian,28,12,16,27,11,16,11,11,0,6,6,0,2,2,0,4,4,0,0,0,0
,,American Indian/Alaska Native,23,4,19,21,3,18,5,4,1,1,1,0,3,3,0,0,0,0,0,0,0
,,Pacific Islander,2,1,1,2,1,1,1,1,0,1,1,0,1,1,0,0,0,0,0,0,0
,,Multiracial,7,0,7,7,0,7,0,0,0,0,0,0,0,0,0,0,0,0,0,0,0
,Wyoming,All Ethnicities,202,84,118,193,79,114,71,68,3,28,28,0,16,16,0,11,10,1,0,0,0
,,White,188,77,111,181,73,108,64,62,2,26,26,0,16,16,0,10,9,1,0,0,0
,,Black,1,1,0,1,1,0,1,1,0,0,0,0,0,0,0,0,0,0,0,0,0
,,Hispanic,8,3,5,6,2,4,4,3,1,1,1,0,0,0,0,0,0,0,0,0,0
,,Asian,1,1,0,1,1,0,0,0,0,0,0,0,0,0,0,1,1,0,0,0,0
,,American Indian/Alaska Native,4,2,2,4,2,2,2,2,0,1,1,0,0,0,0,0,0,0,0,0,0
50-64 Years,All Donor States of Residence,All Ethnicities,89826,53900,35926,84059,49048,35011,41412,40577,835,5773,5767,6,2471,2455,16,5952,5892,60,60,52,8
,,White,68461,39060,29401,65148,36558,28590,29462,28726,736,4537,4531,6,2151,2137,14,4085,4027,58,46,40,6
,,Black,9624,7351,2273,8062,5815,2247,6245,6221,24,515,515,0,167,166,1,880,880,0,6,5,1
,,Hispanic,8143,5388,2755,7473,4775,2698,4049,3995,54,555,555,0,107,106,1,661,659,2,8,7,1
,,Unknown,57,39,18,55,37,18,30,30,0,5,5,0,3,3,0,0,0,0,0,0,0
,,Asian,2514,1419,1095,2371,1294,1077,1139,1121,18,123,123,0,31,31,0,257,257,0,0,0,0
,,American Indian/Alaska Native,284,152,132,275,144,131,90,89,1,16,16,0,6,6,0,15,15,0,0,0,0
,,Pacific Islander,232,130,102,221,119,102,100,100,0,4,4,0,3,3,0,20,20,0,0,0,0
,,Multiracial,511,361,150,454,306,148,297,295,2,18,18,0,3,3,0,34,34,0,0,0,0
,Alabama,All Ethnicities,1400,886,514,1291,779,512,727,726,1,35,35,0,11,10,1,44,44,0,0,0,0
,,White,1101,663,438,1038,602,436,532,531,1,29,29,0,8,7,1,30,30,0,0,0,0
,,Black,284,215,69,240,171,69,188,188,0,6,6,0,3,3,0,13,13,0,0,0,0
,,Hispanic,7,3,4,7,3,4,3,3,0,0,0,0,0,0,0,0,0,0,0,0,0
,,Asian,7,4,3,5,2,3,4,4,0,0,0,0,0,0,0,1,1,0,0,0,0
,,American Indian/Alaska Native,1,1,0,1,1,0,0,0,0,0,0,0,0,0,0,0,0,0,0,0,0
,Alaska,All Ethnicities,197,100,97,193,97,96,75,74,1,10,10,0,2,2,0,10,10,0,0,0,0
,,White,161,75,86,157,72,85,57,56,1,8,8,0,1,1,0,8,8,0,0,0,0
,,Black,5,4,1,5,4,1,2,2,0,0,0,0,0,0,0,0,0,0,0,0,0
,,Hispanic,4,3,1,4,3,1,2,2,0,1,1,0,0,0,0,1,1,0,0,0,0
,,Asian,3,3,0,3,3,0,3,3,0,1,1,0,1,1,0,0,0,0,0,0,0
,,American Indian/Alaska Native,20,12,8,20,12,8,8,8,0,0,0,0,0,0,0,0,0,0,0,0,0
,,Pacific Islander,3,3,0,3,3,0,3,3,0,0,0,0,0,0,0,1,1,0,0,0,0
,,Multiracial,1,0,1,1,0,1,0,0,0,0,0,0,0,0,0,0,0,0,0,0,0
,Arizona,All Ethnicities,1505,769,736,1437,722,715,598,578,20,64,64,0,13,13,0,83,82,1,1,1,0
,,White,1175,585,590,1137,563,574,448,433,15,49,49,0,10,10,0,58,57,1,0,0,0
,,Black,56,36,20,46,26,20,30,30,0,1,1,0,0,0,0,4,4,0,0,0,0
,,,,,,,,,,,,,,,,,,,,,,,
,,,,,,,,,,,,,,,,,,,,,,,
,,Hispanic,228,125,103,209,111,98,105,100,5,12,12,0,2,2,0,17,17,0,1,1,0
,,Asian,18,9,9,18,9,9,9,9,0,1,1,0,1,1,0,2,2,0,0,0,0
,,American Indian/Alaska Native,24,12,12,23,11,12,5,5,0,1,1,0,0,0,0,2,2,0,0,0,0
,,Pacific Islander,2,1,1,2,1,1,1,1,0,0,0,0,0,0,0,0,0,0,0,0,0
,,Multiracial,2,1,1,2,1,1,0,0,0,0,0,0,0,0,0,0,0,0,0,0,0
,Arkansas,All Ethnicities,601,392,209,565,360,205,329,327,2,34,34,0,12,12,0,40,38,2,1,1,0
,,White,518,327,191,493,306,187,275,273,2,30,30,0,11,11,0,33,31,2,1,1,0
,,Black,71,56,15,60,45,15,49,49,0,3,3,0,1,1,0,7,7,0,0,0,0
,,Hispanic,11,9,2,11,9,2,5,5,0,1,1,0,0,0,0,0,0,0,0,0,0
,,Asian,1,0,1,1,0,1,0,0,0,0,0,0,0,0,0,0,0,0,0,0,0
,California,All Ethnicities,9249,5692,3557,8732,5292,3440,4363,4267,96,744,743,1,157,157,0,783,764,19,3,2,1
,,White,5591,3206,2385,5350,3052,2298,2447,2380,67,460,459,1,120,120,0,396,378,18,3,2,1
,,Black,648,477,171,572,404,168,406,403,3,29,29,0,5,5,0,65,65,0,0,0,0
,,Hispanic,2013,1390,623,1874,1270,604,1014,996,18,200,200,0,21,21,0,207,206,1,0,0,0
,,Unknown,3,1,2,2,0,2,1,1,0,0,0,0,0,0,0,0,0,0,0,0,0
,,Asian,808,509,299,757,466,291,407,399,8,43,43,0,7,7,0,95,95,0,0,0,0
,,American Indian/Alaska Native,33,19,14,33,19,14,12,12,0,5,5,0,2,2,0,2,2,0,0,0,0
,,Pacific Islander,79,48,31,73,42,31,39,39,0,4,4,0,1,1,0,14,14,0,0,0,0
,,Multiracial,74,42,32,71,39,32,37,37,0,3,3,0,1,1,0,4,4,0,0,0,0
,Colorado,All Ethnicities,1269,597,672,1211,565,646,460,434,26,75,75,0,44,44,0,48,48,0,3,3,0
,,White,1065,483,582,1021,463,558,375,351,24,65,65,0,40,40,0,39,39,0,3,3,0
,,Black,48,33,15,42,27,15,29,29,0,5,5,0,1,1,0,3,3,0,0,0,0
,,Hispanic,121,59,62,116,56,60,41,39,2,2,2,0,2,2,0,4,4,0,0,0,0
,,Asian,22,16,6,20,14,6,10,10,0,2,2,0,1,1,0,1,1,0,0,0,0
,,American Indian/Alaska Native,7,5,2,7,5,2,4,4,0,1,1,0,0,0,0,1,1,0,0,0,0
,,Pacific Islander,2,1,1,1,0,1,1,1,0,0,0,0,0,0,0,0,0,0,0,0,0
,,Multiracial,4,0,4,4,0,4,0,0,0,0,0,0,0,0,0,0,0,0,0,0,0
,Connecticut,All Ethnicities,1105,487,618,1051,453,598,370,350,20,73,73,0,19,19,0,41,41,0,0,0,0
,,White,943,400,543,903,380,523,305,285,20,64,64,0,17,17,0,32,32,0,0,0,0
,,Black,66,38,28,58,30,28,31,31,0,3,3,0,1,1,0,4,4,0,0,0,0
,,Hispanic,71,44,27,65,38,27,30,30,0,3,3,0,1,1,0,2,2,0,0,0,0
,,Asian,21,5,16,21,5,16,4,4,0,3,3,0,0,0,0,3,3,0,0,0,0
,,Multiracial,4,0,4,4,0,4,0,0,0,0,0,0,0,0,0,0,0,0,0,0,0
,Delaware,All Ethnicities,356,263,93,332,240,92,199,198,1,36,36,0,13,13,0,23,23,0,0,0,0
,,White,285,210,75,276,202,74,150,149,1,34,34,0,13,13,0,17,17,0,0,0,0
,,Black,60,47,13,46,33,13,43,43,0,2,2,0,0,0,0,5,5,0,0,0,0
,,Hispanic,4,2,2,3,1,2,2,2,0,0,0,0,0,0,0,0,0,0,0,0,0
,,Asian,6,4,2,6,4,2,4,4,0,0,0,0,0,0,0,1,1,0,0,0,0
,,Pacific Islander,1,0,1,1,0,1,0,0,0,0,0,0,0,0,0,0,0,0,0,0,0
,District of Columbia,All Ethnicities,236,156,80,208,131,77,121,119,2,5,5,0,3,3,0,15,14,1,0,0,0
,,White,61,22,39,58,21,37,17,16,1,1,1,0,0,0,0,3,2,1,0,0,0
,,,,,,,,,,,,,,,,,,,,,,,
,,,,,,,,,,,,,,,,,,,,,,,
,,Black,164,127,37,141,105,36,98,97,1,4,4,0,3,3,0,10,10,0,0,0,0
,,Hispanic,7,6,1,5,4,1,5,5,0,0,0,0,0,0,0,2,2,0,0,0,0
,,Asian,2,0,2,2,0,2,0,0,0,0,0,0,0,0,0,0,0,0,0,0,0
,,Pacific Islander,1,0,1,1,0,1,0,0,0,0,0,0,0,0,0,0,0,0,0,0,0
,,Multiracial,1,1,0,1,1,0,1,1,0,0,0,0,0,0,0,0,0,0,0,0,0
,Florida,All Ethnicities,5107,3564,1543,4698,3177,1521,2703,2685,18,280,280,0,78,76,2,354,351,3,6,6,0
,,White,3771,2555,1216,3538,2338,1200,1886,1873,13,217,217,0,59,58,1,234,231,3,2,2,0
,,Black,525,443,82,420,341,79,381,379,2,25,25,0,8,7,1,51,51,0,1,1,0
,,Hispanic,690,490,200,628,431,197,375,372,3,37,37,0,11,11,0,55,55,0,3,3,0
,,Unknown,7,6,1,6,5,1,5,5,0,0,0,0,0,0,0,0,0,0,0,0,0
,,Asian,80,49,31,72,41,31,39,39,0,0,0,0,0,0,0,13,13,0,0,0,0
,,American Indian/Alaska Native,5,2,3,5,2,3,2,2,0,1,1,0,0,0,0,0,0,0,0,0,0
,,Pacific Islander,7,4,3,7,4,3,3,3,0,0,0,0,0,0,0,0,0,0,0,0,0
,,Multiracial,22,15,7,22,15,7,12,12,0,0,0,0,0,0,0,1,1,0,0,0,0
,Georgia,All Ethnicities,2424,1584,840,2154,1325,829,1308,1298,10,140,140,0,13,12,1,185,185,0,0,0,0
,,White,1678,1004,674,1562,899,663,794,784,10,97,97,0,11,10,1,88,88,0,0,0,0
,,Black,641,509,132,498,366,132,456,456,0,37,37,0,2,2,0,84,84,0,0,0,0
,,Hispanic,62,47,15,54,39,15,39,39,0,5,5,0,0,0,0,7,7,0,0,0,0
,,Asian,37,22,15,36,21,15,17,17,0,1,1,0,0,0,0,6,6,0,0,0,0
,,Pacific Islander,3,1,2,2,0,2,1,1,0,0,0,0,0,0,0,0,0,0,0,0,0
,,Multiracial,3,1,2,2,0,2,1,1,0,0,0,0,0,0,0,0,0,0,0,0,0
,Hawaii,All Ethnicities,375,227,148,365,220,145,166,163,3,4,4,0,1,1,0,4,4,0,0,0,0
,,White,136,70,66,132,68,64,48,46,2,2,2,0,0,0,0,2,2,0,0,0,0
,,Black,1,1,0,1,1,0,1,1,0,0,0,0,0,0,0,0,0,0,0,0,0
,,Hispanic,7,4,3,7,4,3,2,2,0,0,0,0,0,0,0,0,0,0,0,0,0
,,Asian,155,102,53,149,97,52,81,80,1,2,2,0,1,1,0,2,2,0,0,0,0
,,American Indian/Alaska Native,3,1,2,3,1,2,0,0,0,0,0,0,0,0,0,0,0,0,0,0,0
,,Pacific Islander,52,40,12,52,40,12,26,26,0,0,0,0,0,0,0,0,0,0,0,0,0
,,Multiracial,21,9,12,21,9,12,8,8,0,0,0,0,0,0,0,0,0,0,0,0,0
,Idaho,All Ethnicities,359,189,170,351,184,167,138,136,2,21,20,1,4,4,0,18,18,0,0,0,0
,,White,336,178,158,328,173,155,131,129,2,21,20,1,3,3,0,15,15,0,0,0,0
,,Black,2,1,1,2,1,1,1,1,0,0,0,0,1,1,0,0,0,0,0,0,0
,,Hispanic,16,8,8,16,8,8,4,4,0,0,0,0,0,0,0,2,2,0,0,0,0
,,Asian,2,1,1,2,1,1,1,1,0,0,0,0,0,0,0,1,1,0,0,0,0
,,American Indian/Alaska Native,2,1,1,2,1,1,1,1,0,0,0,0,0,0,0,0,0,0,0,0,0
,,Pacific Islander,1,0,1,1,0,1,0,0,0,0,0,0,0,0,0,0,0,0,0,0,0
,Illinois,All Ethnicities,4121,2513,1608,3809,2246,1563,1819,1779,40,234,234,0,275,274,1,314,313,1,10,7,3
,,White,3002,1717,1285,2847,1604,1243,1191,1153,38,169,169,0,212,211,1,207,206,1,4,2,2
,,Black,704,556,148,587,439,148,465,465,0,42,42,0,49,49,0,69,69,0,3,3,0
,,Hispanic,302,179,123,271,151,120,118,116,2,17,17,0,10,10,0,23,23,0,3,2,1
,,Asian,98,55,43,90,47,43,40,40,0,6,6,0,3,3,0,13,13,0,0,0,0
,,,,,,,,,,,,,,,,,,,,,,,
,,,,,,,,,,,,,,,,,,,,,,,
,,American Indian/Alaska Native,5,4,1,4,3,1,3,3,0,0,0,0,1,1,0,1,1,0,0,0,0
,,Pacific Islander,4,1,3,4,1,3,1,1,0,0,0,0,0,0,0,0,0,0,0,0,0
,,Multiracial,6,1,5,6,1,5,1,1,0,0,0,0,0,0,0,1,1,0,0,0,0
,Indiana,All Ethnicities,1572,963,609,1474,878,596,793,781,12,124,124,0,47,46,1,138,138,0,0,0,0
,,White,1378,820,558,1312,765,547,673,663,10,111,111,0,42,41,1,112,112,0,0,0,0
,,Black,140,115,25,111,86,25,97,97,0,10,10,0,3,3,0,18,18,0,0,0,0
,,Hispanic,34,16,18,33,16,17,12,11,1,1,1,0,1,1,0,5,5,0,0,0,0
,,Asian,15,8,7,13,7,6,8,7,1,0,0,0,1,1,0,3,3,0,0,0,0
,,American Indian/Alaska Native,3,2,1,3,2,1,1,1,0,1,1,0,0,0,0,0,0,0,0,0,0
,,Pacific Islander,1,1,0,1,1,0,1,1,0,0,0,0,0,0,0,0,0,0,0,0,0
,,Multiracial,1,1,0,1,1,0,1,1,0,1,1,0,0,0,0,0,0,0,0,0,0
,Iowa,All Ethnicities,902,457,445,869,429,440,357,352,5,65,65,0,39,39,0,38,38,0,0,0,0
,,White,875,440,435,844,414,430,345,340,5,64,64,0,39,39,0,36,36,0,0,0,0
,,Black,14,8,6,12,6,6,5,5,0,0,0,0,0,0,0,2,2,0,0,0,0
,,Hispanic,8,5,3,8,5,3,4,4,0,0,0,0,0,0,0,0,0,0,0,0,0
,,Asian,4,3,1,4,3,1,3,3,0,1,1,0,0,0,0,0,0,0,0,0,0
,,American Indian/Alaska Native,1,1,0,1,1,0,0,0,0,0,0,0,0,0,0,0,0,0,0,0,0
,Kansas,All Ethnicities,769,524,245,724,482,242,409,406,3,56,56,0,34,33,1,62,62,0,1,1,0
,,White,685,456,229,651,425,226,350,347,3,52,52,0,33,32,1,52,52,0,1,1,0
,,Black,42,39,3,35,32,3,35,35,0,2,2,0,1,1,0,4,4,0,0,0,0
,,Hispanic,32,24,8,28,20,8,19,19,0,2,2,0,0,0,0,5,5,0,0,0,0
,,Asian,7,5,2,7,5,2,5,5,0,0,0,0,0,0,0,1,1,0,0,0,0
,,American Indian/Alaska Native,1,0,1,1,0,1,0,0,0,0,0,0,0,0,0,0,0,0,0,0,0
,,Pacific Islander,1,0,1,1,0,1,0,0,0,0,0,0,0,0,0,0,0,0,0,0,0
,,Multiracial,1,0,1,1,0,1,0,0,0,0,0,0,0,0,0,0,0,0,0,0,0
,Kentucky,All Ethnicities,965,644,321,923,602,321,517,517,0,70,70,0,34,34,0,66,66,0,0,0,0
,,White,891,587,304,857,553,304,465,465,0,64,64,0,33,33,0,62,62,0,0,0,0
,,Black,62,49,13,57,44,13,45,45,0,5,5,0,0,0,0,4,4,0,0,0,0
,,Hispanic,9,6,3,7,4,3,5,5,0,1,1,0,1,1,0,0,0,0,0,0,0
,,Asian,1,0,1,1,0,1,0,0,0,0,0,0,0,0,0,0,0,0,0,0,0
,,American Indian/Alaska Native,1,1,0,0,0,0,1,1,0,0,0,0,0,0,0,0,0,0,0,0,0
,,Pacific Islander,1,1,0,1,1,0,1,1,0,0,0,0,0,0,0,0,0,0,0,0,0
,Louisiana,All Ethnicities,1218,879,339,1074,740,334,780,776,4,53,53,0,17,17,0,93,93,0,1,0,1
,,White,801,526,275,743,473,270,463,459,4,42,42,0,16,16,0,65,65,0,1,0,1
,,Black,382,330,52,300,248,52,300,300,0,9,9,0,1,1,0,27,27,0,0,0,0
,,Hispanic,20,15,5,17,12,5,11,11,0,1,1,0,0,0,0,1,1,0,0,0,0
,,Unknown,1,1,0,1,1,0,1,1,0,1,1,0,0,0,0,0,0,0,0,0,0
,,Asian,11,5,6,10,4,6,4,4,0,0,0,0,0,0,0,0,0,0,0,0,0
,,American Indian/Alaska Native,2,1,1,2,1,1,0,0,0,0,0,0,0,0,0,0,0,0,0,0,0
,,Multiracial,1,1,0,1,1,0,1,1,0,0,0,0,0,0,0,0,0,0,0,0,0
,Maine,All Ethnicities,461,220,241,437,213,224,156,142,14,30,30,0,17,16,1,23,20,3,0,0,0
,,,,,,,,,,,,,,,,,,,,,,,
,,,,,,,,,,,,,,,,,,,,,,,
,,White,445,212,233,424,206,218,147,135,12,29,29,0,16,15,1,23,20,3,0,0,0
,,Black,9,3,6,7,2,5,4,3,1,0,0,0,0,0,0,0,0,0,0,0,0
,,Hispanic,5,4,1,4,4,0,4,3,1,1,1,0,1,1,0,0,0,0,0,0,0
,,Asian,2,1,1,2,1,1,1,1,0,0,0,0,0,0,0,0,0,0,0,0,0
,Maryland,All Ethnicities,2186,1236,950,2023,1105,918,1010,978,32,110,110,0,40,40,0,184,184,0,3,3,0
,,White,1533,815,718,1453,765,688,652,622,30,81,81,0,33,33,0,106,106,0,2,2,0
,,Black,508,339,169,432,264,168,288,287,1,23,23,0,7,7,0,55,55,0,0,0,0
,,Hispanic,65,39,26,62,37,25,32,31,1,3,3,0,0,0,0,10,10,0,1,1,0
,,Asian,69,41,28,66,38,28,36,36,0,3,3,0,0,0,0,13,13,0,0,0,0
,,American Indian/Alaska Native,5,1,4,5,1,4,1,1,0,0,0,0,0,0,0,0,0,0,0,0,0
,,Pacific Islander,2,0,2,2,0,2,0,0,0,0,0,0,0,0,0,0,0,0,0,0,0
,,Multiracial,4,1,3,3,0,3,1,1,0,0,0,0,0,0,0,0,0,0,0,0,0
,Massachusetts,All Ethnicities,2033,967,1066,1923,915,1008,686,634,52,140,140,0,45,45,0,93,87,6,1,1,0
,,White,1805,834,971,1709,793,916,591,542,49,121,121,0,41,41,0,81,75,6,1,1,0
,,Black,88,51,37,80,44,36,36,35,1,4,4,0,1,1,0,4,4,0,0,0,0
,,Hispanic,95,65,30,90,61,29,44,43,1,11,11,0,1,1,0,6,6,0,0,0,0
,,Unknown,1,1,0,1,1,0,0,0,0,0,0,0,0,0,0,0,0,0,0,0,0
,,Asian,37,13,24,36,13,23,12,11,1,2,2,0,2,2,0,2,2,0,0,0,0
,,Pacific Islander,2,0,2,2,0,2,0,0,0,0,0,0,0,0,0,0,0,0,0,0,0
,,Multiracial,5,3,2,5,3,2,3,3,0,2,2,0,0,0,0,0,0,0,0,0,0
,Michigan,All Ethnicities,3514,2040,1474,3337,1888,1449,1372,1351,21,224,224,0,90,90,0,260,257,3,2,1,1
,,White,3035,1691,1344,2931,1608,1323,1107,1089,18,190,190,0,79,79,0,213,210,3,1,1,0
,,Black,380,289,91,315,228,87,222,219,3,25,25,0,10,10,0,38,38,0,1,0,1
,,Hispanic,54,37,17,47,30,17,27,27,0,8,8,0,0,0,0,4,4,0,0,0,0
,,Unknown,2,0,2,2,0,2,0,0,0,0,0,0,0,0,0,0,0,0,0,0,0
,,Asian,31,17,14,30,16,14,15,15,0,1,1,0,0,0,0,5,5,0,0,0,0
,,American Indian/Alaska Native,4,3,1,4,3,1,0,0,0,0,0,0,0,0,0,0,0,0,0,0,0
,,Pacific Islander,3,1,2,3,1,2,1,1,0,0,0,0,1,1,0,0,0,0,0,0,0
,,Multiracial,5,2,3,5,2,3,0,0,0,0,0,0,0,0,0,0,0,0,0,0,0
,Minnesota,All Ethnicities,2006,834,1172,1935,797,1138,687,656,31,142,141,1,169,167,2,102,101,1,9,8,1
,,White,1919,793,1126,1856,762,1094,650,621,29,140,139,1,164,162,2,97,96,1,9,8,1
,,Black,37,18,19,33,15,18,17,16,1,0,0,0,1,1,0,1,1,0,0,0,0
,,Hispanic,19,11,8,17,9,8,9,9,0,1,1,0,2,2,0,2,2,0,0,0,0
,,Unknown,1,0,1,1,0,1,0,0,0,0,0,0,0,0,0,0,0,0,0,0,0
,,Asian,13,6,7,12,5,7,6,6,0,1,1,0,0,0,0,2,2,0,0,0,0
,,American Indian/Alaska Native,13,5,8,13,5,8,3,3,0,0,0,0,1,1,0,0,0,0,0,0,0
,,Pacific Islander,1,1,0,1,1,0,1,1,0,0,0,0,1,1,0,0,0,0,0,0,0
,,Multiracial,3,0,3,2,0,2,1,0,1,0,0,0,0,0,0,0,0,0,0,0,0
,Mississippi,All Ethnicities,658,479,179,613,438,175,377,373,4,41,41,0,10,10,0,38,38,0,0,0,0
,,White,460,310,150,435,289,146,237,233,4,30,30,0,9,9,0,22,22,0,0,0,0
,,Black,187,159,28,167,139,28,132,132,0,7,7,0,1,1,0,15,15,0,0,0,0
,,,,,,,,,,,,,,,,,,,,,,,
,,,,,,,,,,,,,,,,,,,,,,,
,,Hispanic,10,9,1,10,9,1,7,7,0,4,4,0,0,0,0,0,0,0,0,0,0
,,Asian,1,1,0,1,1,0,1,1,0,0,0,0,0,0,0,1,1,0,0,0,0
,Missouri,All Ethnicities,1796,1293,503,1635,1135,500,1044,1041,3,106,106,0,65,65,0,173,173,0,1,1,0
,,White,1520,1056,464,1417,956,461,830,827,3,92,92,0,59,59,0,136,136,0,1,1,0
,,Black,224,199,25,172,147,25,183,183,0,10,10,0,6,6,0,33,33,0,0,0,0
,,Hispanic,31,25,6,26,20,6,18,18,0,2,2,0,0,0,0,3,3,0,0,0,0
,,Asian,14,9,5,14,9,5,9,9,0,0,0,0,0,0,0,1,1,0,0,0,0
,,American Indian/Alaska Native,3,2,1,2,1,1,2,2,0,1,1,0,0,0,0,0,0,0,0,0,0
,,Multiracial,4,2,2,4,2,2,2,2,0,1,1,0,0,0,0,0,0,0,0,0,0
,Montana,All Ethnicities,279,143,136,274,139,135,102,101,1,20,20,0,8,8,0,14,14,0,0,0,0
,,White,262,131,131,257,127,130,96,95,1,20,20,0,7,7,0,12,12,0,0,0,0
,,Hispanic,6,5,1,6,5,1,3,3,0,0,0,0,0,0,0,0,0,0,0,0,0
,,Asian,1,1,0,1,1,0,1,1,0,0,0,0,0,0,0,0,0,0,0,0,0
,,American Indian/Alaska Native,9,5,4,9,5,4,1,1,0,0,0,0,1,1,0,2,2,0,0,0,0
,,Multiracial,1,1,0,1,1,0,1,1,0,0,0,0,0,0,0,0,0,0,0,0,0
,Nebraska,All Ethnicities,589,319,270,563,298,265,250,246,4,28,28,0,35,35,0,35,34,1,0,0,0
,,White,536,280,256,514,263,251,220,216,4,27,27,0,33,33,0,30,29,1,0,0,0
,,Black,27,23,4,24,20,4,18,18,0,1,1,0,2,2,0,1,1,0,0,0,0
,,Hispanic,19,12,7,18,11,7,10,10,0,0,0,0,0,0,0,3,3,0,0,0,0
,,Asian,3,2,1,3,2,1,1,1,0,0,0,0,0,0,0,1,1,0,0,0,0
,,American Indian/Alaska Native,4,2,2,4,2,2,1,1,0,0,0,0,0,0,0,0,0,0,0,0,0
,Nevada,All Ethnicities,741,536,205,683,483,200,419,415,4,58,58,0,9,9,0,49,48,1,0,0,0
,,White,537,367,170,498,332,166,283,280,3,39,39,0,7,7,0,30,29,1,0,0,0
,,Black,61,51,10,51,41,10,45,45,0,6,6,0,1,1,0,5,5,0,0,0,0
,,Hispanic,89,74,15,83,69,14,56,55,1,9,9,0,1,1,0,5,5,0,0,0,0
,,Asian,39,32,7,37,30,7,24,24,0,4,4,0,0,0,0,9,9,0,0,0,0
,,American Indian/Alaska Native,5,3,2,5,3,2,2,2,0,0,0,0,0,0,0,0,0,0,0,0,0
,,Pacific Islander,7,6,1,7,6,1,6,6,0,0,0,0,0,0,0,0,0,0,0,0,0
,,Multiracial,3,3,0,2,2,0,3,3,0,0,0,0,0,0,0,0,0,0,0,0,0
,New Hampshire,All Ethnicities,480,220,260,455,207,248,162,151,11,29,29,0,12,12,0,28,27,1,0,0,0
,,White,467,212,255,442,199,243,156,145,11,28,28,0,12,12,0,26,25,1,0,0,0
,,Black,3,3,0,3,3,0,2,2,0,1,1,0,0,0,0,1,1,0,0,0,0
,,Hispanic,6,4,2,6,4,2,3,3,0,0,0,0,0,0,0,1,1,0,0,0,0
,,Asian,4,1,3,4,1,3,1,1,0,0,0,0,0,0,0,0,0,0,0,0,0
,New Jersey,All Ethnicities,2994,1593,1401,2834,1465,1369,1204,1172,32,169,169,0,83,83,0,131,131,0,0,0,0
,,White,2131,1073,1058,2041,1014,1027,784,753,31,113,113,0,66,66,0,77,77,0,0,0,0
,,Black,349,223,126,306,180,126,182,182,0,18,18,0,5,5,0,18,18,0,0,0,0
,,Hispanic,354,223,131,336,206,130,178,177,1,33,33,0,10,10,0,27,27,0,0,0,0
,,Unknown,1,0,1,1,0,1,0,0,0,0,0,0,0,0,0,0,0,0,0,0,0
,,Asian,140,64,76,132,56,76,51,51,0,5,5,0,2,2,0,7,7,0,0,0,0
,,American Indian/Alaska Native,3,0,3,3,0,3,0,0,0,0,0,0,0,0,0,0,0,0,0,0,0
,,,,,,,,,,,,,,,,,,,,,,,
,,,,,,,,,,,,,,,,,,,,,,,
,,Pacific Islander,7,6,1,6,5,1,5,5,0,0,0,0,0,0,0,2,2,0,0,0,0
,,Multiracial,9,4,5,9,4,5,4,4,0,0,0,0,0,0,0,0,0,0,0,0,0
,New Mexico,All Ethnicities,482,282,200,455,261,194,205,200,5,27,27,0,8,8,0,15,15,0,1,0,1
,,White,305,175,130,288,162,126,132,129,3,19,19,0,5,5,0,5,5,0,1,0,1
,,Black,7,7,0,6,6,0,6,6,0,0,0,0,0,0,0,1,1,0,0,0,0
,,Hispanic,157,93,64,151,87,64,60,60,0,8,8,0,3,3,0,9,9,0,0,0,0
,,Asian,5,4,1,3,3,0,5,4,1,0,0,0,0,0,0,0,0,0,0,0,0
,,American Indian/Alaska Native,5,2,3,4,2,2,1,0,1,0,0,0,0,0,0,0,0,0,0,0,0
,,Pacific Islander,1,0,1,1,0,1,0,0,0,0,0,0,0,0,0,0,0,0,0,0,0
,,Multiracial,2,1,1,2,1,1,1,1,0,0,0,0,0,0,0,0,0,0,0,0,0
,New York,All Ethnicities,5651,2997,2654,5183,2634,2549,2355,2250,105,307,307,0,104,103,1,189,189,0,1,1,0
,,White,3863,1865,1998,3625,1717,1908,1434,1344,90,191,191,0,80,79,1,121,121,0,1,1,0
,,Black,722,483,239,601,366,235,411,407,4,49,49,0,9,9,0,26,26,0,0,0,0
,,Hispanic,802,515,287,704,427,277,412,402,10,49,49,0,12,12,0,32,32,0,0,0,0
,,Unknown,2,1,1,2,1,1,0,0,0,0,0,0,1,1,0,0,0,0,0,0,0
,,Asian,192,90,102,184,83,101,69,68,1,13,13,0,2,2,0,8,8,0,0,0,0
,,American Indian/Alaska Native,7,5,2,7,5,2,0,0,0,0,0,0,0,0,0,0,0,0,0,0,0
,,Pacific Islander,14,4,10,14,4,10,3,3,0,0,0,0,0,0,0,1,1,0,0,0,0
,,Multiracial,49,34,15,46,31,15,26,26,0,5,5,0,0,0,0,1,1,0,0,0,0
,North Carolina,All Ethnicities,2285,1478,807,2147,1354,793,1060,1050,10,237,237,0,57,57,0,223,219,4,1,1,0
,,White,1802,1103,699,1719,1034,685,769,759,10,181,181,0,48,48,0,151,147,4,1,1,0
,,Black,400,314,86,346,260,86,245,245,0,40,40,0,6,6,0,56,56,0,0,0,0
,,Hispanic,41,31,10,41,31,10,22,22,0,10,10,0,2,2,0,10,10,0,0,0,0
,,Asian,19,16,3,18,15,3,11,11,0,3,3,0,1,1,0,3,3,0,0,0,0
,,American Indian/Alaska Native,16,11,5,16,11,5,10,10,0,1,1,0,0,0,0,2,2,0,0,0,0
,,Multiracial,7,3,4,7,3,4,3,3,0,2,2,0,0,0,0,1,1,0,0,0,0
,North Dakota,All Ethnicities,224,94,130,214,88,126,82,78,4,11,11,0,16,16,0,12,12,0,1,1,0
,,White,211,90,121,201,84,117,79,75,4,11,11,0,16,16,0,11,11,0,1,1,0
,,Black,4,2,2,4,2,2,2,2,0,0,0,0,0,0,0,0,0,0,0,0,0
,,Hispanic,4,2,2,4,2,2,1,1,0,0,0,0,0,0,0,1,1,0,0,0,0
,,Asian,1,0,1,1,0,1,0,0,0,0,0,0,0,0,0,0,0,0,0,0,0
,,American Indian/Alaska Native,2,0,2,2,0,2,0,0,0,0,0,0,0,0,0,0,0,0,0,0,0
,,Multiracial,2,0,2,2,0,2,0,0,0,0,0,0,0,0,0,0,0,0,0,0,0
,Ohio,All Ethnicities,3670,2176,1494,3464,1995,1469,1682,1657,25,222,222,0,145,145,0,251,251,0,2,2,0
,,White,3255,1876,1379,3110,1755,1355,1422,1398,24,194,194,0,135,135,0,209,209,0,2,2,0
,,Black,345,259,86,291,205,86,224,224,0,21,21,0,8,8,0,36,36,0,0,0,0
,,Hispanic,33,21,12,30,18,12,19,19,0,4,4,0,0,0,0,1,1,0,0,0,0
,,Asian,28,17,11,25,14,11,14,14,0,2,2,0,2,2,0,4,4,0,0,0,0
,,American Indian/Alaska Native,1,0,1,1,0,1,0,0,0,0,0,0,0,0,0,0,0,0,0,0,0
,,Pacific Islander,2,1,1,2,1,1,0,0,0,0,0,0,0,0,0,0,0,0,0,0,0
,,Multiracial,6,2,4,5,2,3,3,2,1,1,1,0,0,0,0,1,1,0,0,0,0
,,,,,,,,,,,,,,,,,,,,,,,
,,,,,,,,,,,,,,,,,,,,,,,
,Oklahoma,All Ethnicities,968,678,290,917,630,287,480,477,3,65,65,0,12,12,0,44,44,0,0,0,0
,,White,835,582,253,793,543,250,409,406,3,63,63,0,12,12,0,35,35,0,0,0,0
,,Black,51,42,9,45,36,9,37,37,0,0,0,0,0,0,0,4,4,0,0,0,0
,,Hispanic,37,29,8,35,27,8,20,20,0,2,2,0,0,0,0,3,3,0,0,0,0
,,Asian,12,6,6,12,6,6,2,2,0,0,0,0,0,0,0,0,0,0,0,0,0
,,American Indian/Alaska Native,33,19,14,32,18,14,12,12,0,0,0,0,0,0,0,2,2,0,0,0,0
,Oregon,All Ethnicities,918,472,446,895,456,439,377,374,3,64,62,2,23,23,0,34,32,2,1,1,0
,,White,855,440,415,836,427,409,353,351,2,61,59,2,21,21,0,32,30,2,1,1,0
,,Black,6,4,2,5,3,2,3,3,0,0,0,0,0,0,0,0,0,0,0,0,0
,,Hispanic,28,13,15,27,13,14,9,8,1,2,2,0,0,0,0,0,0,0,0,0,0
,,Asian,17,11,6,16,10,6,9,9,0,1,1,0,1,1,0,2,2,0,0,0,0
,,American Indian/Alaska Native,4,1,3,4,1,3,0,0,0,0,0,0,0,0,0,0,0,0,0,0,0
,,Pacific Islander,2,0,2,2,0,2,0,0,0,0,0,0,0,0,0,0,0,0,0,0,0
,,Multiracial,6,3,3,5,2,3,3,3,0,0,0,0,1,1,0,0,0,0,0,0,0
,Pennsylvania,All Ethnicities,5027,3450,1577,4675,3166,1509,2706,2641,65,458,458,0,231,231,0,394,391,3,3,3,0
,,White,4274,2834,1440,4034,2658,1376,2193,2131,62,388,388,0,213,213,0,313,311,2,3,3,0
,,Black,513,435,78,428,350,78,365,365,0,47,47,0,11,11,0,46,46,0,0,0,0
,,Hispanic,170,144,26,147,123,24,117,116,1,18,18,0,6,6,0,25,24,1,0,0,0
,,Asian,53,29,24,49,27,22,25,23,2,5,5,0,1,1,0,8,8,0,0,0,0
,,Pacific Islander,7,2,5,7,2,5,2,2,0,0,0,0,0,0,0,0,0,0,0,0,0
,,Multiracial,10,6,4,10,6,4,4,4,0,0,0,0,0,0,0,2,2,0,0,0,0
,Puerto Rico,All Ethnicities,724,593,131,631,501,130,447,446,1,3,3,0,1,0,1,44,44,0,0,0,0
,,White,8,4,4,7,3,4,3,3,0,0,0,0,0,0,0,0,0,0,0,0,0
,,Hispanic,509,384,125,460,336,124,277,276,1,2,2,0,1,0,1,21,21,0,0,0,0
,,Unknown,1,0,1,1,0,1,0,0,0,0,0,0,0,0,0,0,0,0,0,0,0
,,Asian,1,0,1,1,0,1,0,0,0,0,0,0,0,0,0,0,0,0,0,0,0
,,Multiracial,205,205,0,162,162,0,167,167,0,1,1,0,0,0,0,23,23,0,0,0,0
,Rhode Island,All Ethnicities,310,129,181,299,123,176,90,85,5,24,24,0,9,9,0,13,13,0,0,0,0
,,White,275,108,167,265,103,162,76,71,5,21,21,0,7,7,0,11,11,0,0,0,0
,,Black,18,10,8,18,10,8,6,6,0,1,1,0,1,1,0,1,1,0,0,0,0
,,Hispanic,13,9,4,12,8,4,7,7,0,1,1,0,1,1,0,0,0,0,0,0,0
,,Asian,3,2,1,3,2,1,1,1,0,1,1,0,0,0,0,1,1,0,0,0,0
,,Multiracial,1,0,1,1,0,1,0,0,0,0,0,0,0,0,0,0,0,0,0,0,0
,South Carolina,All Ethnicities,1201,880,321,1133,814,319,743,741,2,101,101,0,14,14,0,116,116,0,0,0,0
,,White,887,608,279,862,585,277,495,493,2,84,84,0,11,11,0,80,80,0,0,0,0
,,Black,273,241,32,234,202,32,224,224,0,16,16,0,3,3,0,32,32,0,0,0,0
,,Hispanic,26,22,4,24,20,4,15,15,0,1,1,0,0,0,0,4,4,0,0,0,0
,,Asian,11,8,3,9,6,3,8,8,0,0,0,0,0,0,0,0,0,0,0,0,0
,,Pacific Islander,1,0,1,1,0,1,0,0,0,0,0,0,0,0,0,0,0,0,0,0,0
,,Multiracial,3,1,2,3,1,2,1,1,0,0,0,0,0,0,0,0,0,0,0,0,0
,South Dakota,All Ethnicities,261,113,148,256,110,146,95,93,2,13,13,0,21,21,0,15,15,0,1,1,0
,,,,,,,,,,,,,,,,,,,,,,,
,,,,,,,,,,,,,,,,,,,,,,,
,,White,243,102,141,239,100,139,85,83,2,11,11,0,21,21,0,15,15,0,1,1,0
,,Black,1,1,0,1,1,0,1,1,0,0,0,0,0,0,0,0,0,0,0,0,0
,,Hispanic,2,0,2,2,0,2,0,0,0,0,0,0,0,0,0,0,0,0,0,0,0
,,Asian,1,1,0,1,1,0,1,1,0,0,0,0,0,0,0,0,0,0,0,0,0
,,American Indian/Alaska Native,12,8,4,11,7,4,7,7,0,2,2,0,0,0,0,0,0,0,0,0,0
,,Multiracial,2,1,1,2,1,1,1,1,0,0,0,0,0,0,0,0,0,0,0,0,0
,State unassigned,All Ethnicities,1409,646,763,1347,602,745,446,431,15,78,78,0,39,38,1,63,61,2,1,1,0
,,White,707,347,360,676,332,344,221,208,13,53,53,0,27,26,1,25,23,2,1,1,0
,,Black,116,59,57,106,50,56,47,46,1,2,2,0,2,2,0,6,6,0,0,0,0
,,Hispanic,324,162,162,311,149,162,118,118,0,17,17,0,6,6,0,19,19,0,0,0,0
,,Unknown,29,21,8,29,21,8,17,17,0,1,1,0,1,1,0,0,0,0,0,0,0
,,Asian,209,49,160,203,44,159,38,37,1,5,5,0,2,2,0,10,10,0,0,0,0
,,American Indian/Alaska Native,6,3,3,6,3,3,2,2,0,0,0,0,0,0,0,1,1,0,0,0,0
,,Pacific Islander,12,3,9,10,1,9,2,2,0,0,0,0,0,0,0,2,2,0,0,0,0
,,Multiracial,6,2,4,6,2,4,1,1,0,0,0,0,1,1,0,0,0,0,0,0,0
,Tennessee,All Ethnicities,1667,1147,520,1533,1020,513,923,917,6,125,125,0,44,44,0,133,132,1,1,1,0
,,White,1407,942,465,1316,858,458,741,735,6,116,116,0,39,39,0,106,105,1,0,0,0
,,Black,220,175,45,179,134,45,154,154,0,7,7,0,4,4,0,22,22,0,1,1,0
,,Hispanic,22,18,4,22,18,4,17,17,0,1,1,0,1,1,0,3,3,0,0,0,0
,,Asian,14,9,5,13,8,5,9,9,0,1,1,0,0,0,0,2,2,0,0,0,0
,,American Indian/Alaska Native,2,2,0,1,1,0,1,1,0,0,0,0,0,0,0,0,0,0,0,0,0
,,Pacific Islander,1,1,0,1,1,0,1,1,0,0,0,0,0,0,0,0,0,0,0,0,0
,,Multiracial,1,0,1,1,0,1,0,0,0,0,0,0,0,0,0,0,0,0,0,0,0
,Texas,All Ethnicities,5834,3702,2132,5357,3256,2101,2808,2780,28,304,304,0,61,61,0,433,430,3,0,0,0
,,White,3727,2268,1459,3508,2071,1437,1662,1643,19,204,204,0,50,50,0,231,228,3,0,0,0
,,Black,583,479,104,464,363,101,407,404,3,18,18,0,2,2,0,59,59,0,0,0,0
,,Hispanic,1363,856,507,1237,735,502,654,649,5,70,70,0,7,7,0,125,125,0,0,0,0
,,Unknown,8,8,0,8,8,0,6,6,0,3,3,0,1,1,0,0,0,0,0,0,0
,,Asian,122,79,43,111,69,42,70,69,1,6,6,0,1,1,0,17,17,0,0,0,0
,,American Indian/Alaska Native,8,3,5,8,3,5,3,3,0,1,1,0,0,0,0,1,1,0,0,0,0
,,Pacific Islander,3,1,2,3,1,2,1,1,0,0,0,0,0,0,0,0,0,0,0,0,0
,,Multiracial,20,8,12,18,6,12,5,5,0,2,2,0,0,0,0,0,0,0,0,0,0
,Utah,All Ethnicities,606,299,307,568,268,300,217,210,7,46,46,0,8,8,0,21,21,0,0,0,0
,,White,559,260,299,525,233,292,186,179,7,44,44,0,8,8,0,18,18,0,0,0,0
,,Black,5,5,0,5,5,0,5,5,0,0,0,0,0,0,0,1,1,0,0,0,0
,,Hispanic,31,25,6,28,22,6,19,19,0,2,2,0,0,0,0,1,1,0,0,0,0
,,Unknown,1,0,1,1,0,1,0,0,0,0,0,0,0,0,0,0,0,0,0,0,0
,,Asian,8,7,1,7,6,1,6,6,0,0,0,0,0,0,0,1,1,0,0,0,0
,,American Indian/Alaska Native,1,1,0,1,1,0,0,0,0,0,0,0,0,0,0,0,0,0,0,0,0
,,Pacific Islander,1,1,0,1,1,0,1,1,0,0,0,0,0,0,0,0,0,0,0,0,0
,Vermont,All Ethnicities,182,83,99,173,80,93,59,53,6,14,14,0,2,2,0,10,10,0,0,0,0
,,,,,,,,,,,,,,,,,,,,,,,
,,,,,,,,,,,,,,,,,,,,,,,
,,White,181,83,98,172,80,92,59,53,6,14,14,0,2,2,0,10,10,0,0,0,0
,,Hispanic,1,0,1,1,0,1,0,0,0,0,0,0,0,0,0,0,0,0,0,0,0
,Virginia,All Ethnicities,2353,1221,1132,2241,1149,1092,961,923,38,147,146,1,39,39,0,161,160,1,1,1,0
,,White,1797,884,913,1719,844,875,698,662,36,119,118,1,34,34,0,113,112,1,1,1,0
,,Black,387,242,145,357,214,143,192,190,2,15,15,0,2,2,0,28,28,0,0,0,0
,,Hispanic,80,46,34,76,42,34,36,36,0,5,5,0,2,2,0,9,9,0,0,0,0
,,Asian,83,48,35,83,48,35,35,35,0,8,8,0,1,1,0,11,11,0,0,0,0
,,American Indian/Alaska Native,4,1,3,4,1,3,0,0,0,0,0,0,0,0,0,0,0,0,0,0,0
,,Pacific Islander,2,0,2,2,0,2,0,0,0,0,0,0,0,0,0,0,0,0,0,0,0
,Washington,All Ethnicities,1568,811,757,1530,781,749,579,571,8,106,106,0,35,35,0,95,95,0,1,1,0
,,White,1373,689,684,1343,666,677,486,479,7,92,92,0,31,31,0,80,80,0,1,1,0
,,Black,47,31,16,44,28,16,27,27,0,7,7,0,1,1,0,4,4,0,0,0,0
,,Hispanic,48,33,15,48,33,15,26,26,0,3,3,0,2,2,0,4,4,0,0,0,0
,,Asian,69,44,25,65,41,24,32,31,1,2,2,0,1,1,0,6,6,0,0,0,0
,,American Indian/Alaska Native,15,9,6,14,8,6,5,5,0,2,2,0,0,0,0,1,1,0,0,0,0
,,Pacific Islander,6,2,4,6,2,4,0,0,0,0,0,0,0,0,0,0,0,0,0,0,0
,,Multiracial,10,3,7,10,3,7,3,3,0,0,0,0,0,0,0,0,0,0,0,0,0
,West Virginia,All Ethnicities,541,383,158,505,353,152,310,304,6,28,28,0,35,34,1,39,39,0,2,2,0
,,White,515,361,154,484,336,148,292,286,6,26,26,0,33,32,1,35,35,0,2,2,0
,,Black,24,21,3,19,16,3,17,17,0,2,2,0,2,2,0,3,3,0,0,0,0
,,Hispanic,1,1,0,1,1,0,1,1,0,0,0,0,0,0,0,1,1,0,0,0,0
,,Multiracial,1,0,1,1,0,1,0,0,0,0,0,0,0,0,0,0,0,0,0,0,0
,Wisconsin,All Ethnicities,2329,1411,918,2221,1316,905,1012,1000,12,161,161,0,159,157,2,146,145,1,1,1,0
,,White,2139,1257,882,2069,1199,870,892,881,11,144,144,0,155,153,2,130,129,1,1,1,0
,,Black,114,99,15,86,72,14,81,80,1,12,12,0,3,3,0,14,14,0,0,0,0
,,Hispanic,46,38,8,38,30,8,30,30,0,5,5,0,0,0,0,1,1,0,0,0,0
,,Asian,12,10,2,10,8,2,6,6,0,0,0,0,0,0,0,1,1,0,0,0,0
,,American Indian/Alaska Native,13,3,10,13,3,10,1,1,0,0,0,0,1,1,0,0,0,0,0,0,0
,,Multiracial,5,4,1,5,4,1,2,2,0,0,0,0,0,0,0,0,0,0,0,0,0
,Wyoming,All Ethnicities,149,89,60,142,86,56,74,70,4,12,12,0,9,9,0,12,12,0,0,0,0
,,White,140,84,56,133,81,52,70,66,4,12,12,0,9,9,0,12,12,0,0,0,0
,,Hispanic,6,3,3,6,3,3,2,2,0,0,0,0,0,0,0,0,0,0,0,0,0
,,Asian,2,1,1,2,1,1,1,1,0,0,0,0,0,0,0,0,0,0,0,0,0
,,American Indian/Alaska Native,1,1,0,1,1,0,1,1,0,0,0,0,0,0,0,0,0,0,0,0,0
65 +,All Donor States of Residence,All Ethnicities,18954,15974,2980,14897,11938,2959,13647,13628,19,126,126,0,106,106,0,461,459,2,6,6,0
,,White,14879,12243,2636,12069,9452,2617,10398,10381,17,118,118,0,98,98,0,343,341,2,6,6,0
,,Black,1827,1742,85,1140,1055,85,1575,1575,0,3,3,0,3,3,0,46,46,0,0,0,0
,,Hispanic,1422,1290,132,1051,920,131,1070,1069,1,2,2,0,1,1,0,40,40,0,0,0,0
,,Unknown,17,15,2,13,11,2,12,12,0,1,1,0,0,0,0,0,0,0,0,0,0
,,Asian,610,510,100,488,388,100,438,438,0,2,2,0,4,4,0,27,27,0,0,0,0
,,American Indian/Alaska Native,30,24,6,24,18,6,20,20,0,0,0,0,0,0,0,1,1,0,0,0,0
,,,,,,,,,,,,,,,,,,,,,,,
,,,,,,,,,,,,,,,,,,,,,,,
,,Pacific Islander,26,22,4,18,14,4,17,17,0,0,0,0,0,0,0,0,0,0,0,0,0
,,Multiracial,143,128,15,94,80,14,117,116,1,0,0,0,0,0,0,4,4,0,0,0,0
,Alabama,All Ethnicities,252,214,38,214,176,38,181,181,0,0,0,0,0,0,0,5,5,0,0,0,0
,,White,213,176,37,187,150,37,146,146,0,0,0,0,0,0,0,3,3,0,0,0,0
,,Black,36,35,1,24,23,1,32,32,0,0,0,0,0,0,0,1,1,0,0,0,0
,,Hispanic,2,2,0,2,2,0,2,2,0,0,0,0,0,0,0,1,1,0,0,0,0
,,Asian,1,1,0,1,1,0,1,1,0,0,0,0,0,0,0,0,0,0,0,0,0
,Alaska,All Ethnicities,21,16,5,18,13,5,13,13,0,0,0,0,1,1,0,0,0,0,0,0,0
,,White,15,12,3,12,9,3,10,10,0,0,0,0,1,1,0,0,0,0,0,0,0
,,Black,1,0,1,1,0,1,0,0,0,0,0,0,0,0,0,0,0,0,0,0,0
,,Asian,2,2,0,2,2,0,1,1,0,0,0,0,0,0,0,0,0,0,0,0,0
,,American Indian/Alaska Native,3,2,1,3,2,1,2,2,0,0,0,0,0,0,0,0,0,0,0,0,0
,Arizona,All Ethnicities,280,229,51,246,196,50,187,186,1,0,0,0,1,1,0,3,3,0,0,0,0
,,White,229,181,48,203,156,47,147,146,1,0,0,0,1,1,0,3,3,0,0,0,0
,,Black,11,11,0,9,9,0,8,8,0,0,0,0,0,0,0,0,0,0,0,0,0
,,Hispanic,33,31,2,29,27,2,27,27,0,0,0,0,0,0,0,0,0,0,0,0,0
,,Asian,5,5,0,4,4,0,4,4,0,0,0,0,0,0,0,0,0,0,0,0,0
,,American Indian/Alaska Native,2,1,1,1,0,1,1,1,0,0,0,0,0,0,0,0,0,0,0,0,0
,Arkansas,All Ethnicities,104,95,9,82,73,9,87,87,0,0,0,0,0,0,0,5,5,0,0,0,0
,,White,96,87,9,78,69,9,79,79,0,0,0,0,0,0,0,5,5,0,0,0,0
,,Black,5,5,0,3,3,0,5,5,0,0,0,0,0,0,0,0,0,0,0,0,0
,,Hispanic,1,1,0,0,0,0,1,1,0,0,0,0,0,0,0,0,0,0,0,0,0
,,Asian,2,2,0,1,1,0,2,2,0,0,0,0,0,0,0,0,0,0,0,0,0
,California,All Ethnicities,1669,1332,337,1476,1140,336,1055,1054,1,20,20,0,14,14,0,67,67,0,0,0,0
,,White,1048,789,259,949,691,258,623,622,1,18,18,0,11,11,0,34,34,0,0,0,0
,,Black,68,66,2,55,53,2,56,56,0,0,0,0,0,0,0,3,3,0,0,0,0
,,Hispanic,318,283,35,274,239,35,216,216,0,1,1,0,1,1,0,16,16,0,0,0,0
,,Asian,204,170,34,172,138,34,142,142,0,1,1,0,2,2,0,13,13,0,0,0,0
,,American Indian/Alaska Native,6,4,2,5,3,2,3,3,0,0,0,0,0,0,0,0,0,0,0,0,0
,,Pacific Islander,10,9,1,8,7,1,6,6,0,0,0,0,0,0,0,0,0,0,0,0,0
,,Multiracial,15,11,4,13,9,4,9,9,0,0,0,0,0,0,0,1,1,0,0,0,0
,Colorado,All Ethnicities,164,127,37,141,104,37,102,102,0,3,3,0,4,4,0,5,5,0,0,0,0
,,White,147,113,34,128,94,34,90,90,0,3,3,0,4,4,0,5,5,0,0,0,0
,,Black,4,3,1,2,1,1,3,3,0,0,0,0,0,0,0,0,0,0,0,0,0
,,Hispanic,9,8,1,8,7,1,7,7,0,0,0,0,0,0,0,0,0,0,0,0,0
,,Asian,3,3,0,2,2,0,2,2,0,0,0,0,0,0,0,0,0,0,0,0,0
,,Multiracial,1,0,1,1,0,1,0,0,0,0,0,0,0,0,0,0,0,0,0,0,0
,Connecticut,All Ethnicities,187,126,61,165,105,60,110,110,0,6,6,0,0,0,0,7,6,1,0,0,0
,,White,163,106,57,147,91,56,92,92,0,6,6,0,0,0,0,7,6,1,0,0,0
,,Black,12,11,1,10,9,1,9,9,0,0,0,0,0,0,0,0,0,0,0,0,0
,,Hispanic,4,4,0,2,2,0,4,4,0,0,0,0,0,0,0,0,0,0,0,0,0
,,,,,,,,,,,,,,,,,,,,,,,
,,,,,,,,,,,,,,,,,,,,,,,
,,Asian,5,3,2,4,2,2,3,3,0,0,0,0,0,0,0,0,0,0,0,0,0
,,Multiracial,3,2,1,2,1,1,2,2,0,0,0,0,0,0,0,0,0,0,0,0,0
,Delaware,All Ethnicities,125,115,10,101,91,10,100,100,0,1,1,0,1,1,0,5,5,0,0,0,0
,,White,109,99,10,90,80,10,84,84,0,1,1,0,1,1,0,5,5,0,0,0,0
,,Black,12,12,0,7,7,0,12,12,0,0,0,0,0,0,0,0,0,0,0,0,0
,,Hispanic,2,2,0,2,2,0,2,2,0,0,0,0,0,0,0,0,0,0,0,0,0
,,Asian,1,1,0,1,1,0,1,1,0,0,0,0,0,0,0,0,0,0,0,0,0
,,Multiracial,1,1,0,1,1,0,1,1,0,0,0,0,0,0,0,0,0,0,0,0,0
,District of Columbia,All Ethnicities,55,49,6,43,37,6,41,41,0,0,0,0,0,0,0,4,4,0,0,0,0
,,White,11,7,4,11,7,4,4,4,0,0,0,0,0,0,0,1,1,0,0,0,0
,,Black,42,41,1,30,29,1,36,36,0,0,0,0,0,0,0,3,3,0,0,0,0
,,Hispanic,2,1,1,2,1,1,1,1,0,0,0,0,0,0,0,0,0,0,0,0,0
,Florida,All Ethnicities,1407,1254,153,971,819,152,1071,1070,1,3,3,0,3,3,0,21,21,0,1,1,0
,,White,1142,1002,140,793,653,140,852,852,0,3,3,0,3,3,0,13,13,0,1,1,0
,,Black,95,92,3,58,55,3,83,83,0,0,0,0,0,0,0,4,4,0,0,0,0
,,Hispanic,127,121,6,92,86,6,98,98,0,0,0,0,0,0,0,2,2,0,0,0,0
,,Unknown,6,5,1,4,3,1,5,5,0,0,0,0,0,0,0,0,0,0,0,0,0
,,Asian,27,25,2,19,17,2,24,24,0,0,0,0,0,0,0,1,1,0,0,0,0
,,American Indian/Alaska Native,1,1,0,1,1,0,1,1,0,0,0,0,0,0,0,0,0,0,0,0,0
,,Pacific Islander,2,2,0,1,1,0,1,1,0,0,0,0,0,0,0,0,0,0,0,0,0
,,Multiracial,7,6,1,3,3,0,7,6,1,0,0,0,0,0,0,1,1,0,0,0,0
,Georgia,All Ethnicities,520,464,56,352,296,56,417,417,0,0,0,0,0,0,0,11,11,0,0,0,0
,,White,380,335,45,264,219,45,295,295,0,0,0,0,0,0,0,6,6,0,0,0,0
,,Black,122,113,9,75,66,9,109,109,0,0,0,0,0,0,0,4,4,0,0,0,0
,,Hispanic,12,11,1,10,9,1,9,9,0,0,0,0,0,0,0,0,0,0,0,0,0
,,Asian,6,5,1,3,2,1,4,4,0,0,0,0,0,0,0,1,1,0,0,0,0
,Hawaii,All Ethnicities,39,25,14,39,25,14,9,9,0,0,0,0,0,0,0,0,0,0,0,0,0
,,White,22,12,10,22,12,10,3,3,0,0,0,0,0,0,0,0,0,0,0,0,0
,,Asian,16,12,4,16,12,4,6,6,0,0,0,0,0,0,0,0,0,0,0,0,0
,,Pacific Islander,1,1,0,1,1,0,0,0,0,0,0,0,0,0,0,0,0,0,0,0,0
,Idaho,All Ethnicities,28,17,11,25,14,11,14,14,0,0,0,0,0,0,0,0,0,0,0,0,0
,,White,27,16,11,25,14,11,13,13,0,0,0,0,0,0,0,0,0,0,0,0,0
,,Hispanic,1,1,0,0,0,0,1,1,0,0,0,0,0,0,0,0,0,0,0,0,0
,Illinois,All Ethnicities,897,795,102,654,552,102,649,649,0,13,13,0,14,14,0,30,30,0,3,3,0
,,White,683,589,94,530,436,94,475,475,0,12,12,0,12,12,0,23,23,0,3,3,0
,,Black,144,141,3,80,77,3,122,122,0,1,1,0,2,2,0,4,4,0,0,0,0
,,Hispanic,47,44,3,32,29,3,35,35,0,0,0,0,0,0,0,2,2,0,0,0,0
,,Asian,20,19,1,10,9,1,15,15,0,0,0,0,0,0,0,1,1,0,0,0,0
,,American Indian/Alaska Native,1,1,0,0,0,0,1,1,0,0,0,0,0,0,0,0,0,0,0,0,0
,,Multiracial,2,1,1,2,1,1,1,1,0,0,0,0,0,0,0,0,0,0,0,0,0
,Indiana,All Ethnicities,239,208,31,205,174,31,182,182,0,0,0,0,1,1,0,10,10,0,0,0,0
,,,,,,,,,,,,,,,,,,,,,,,
,,,,,,,,,,,,,,,,,,,,,,,
,,White,209,180,29,187,158,29,157,157,0,0,0,0,0,0,0,10,10,0,0,0,0
,,Black,23,22,1,13,12,1,20,20,0,0,0,0,1,1,0,0,0,0,0,0,0
,,Hispanic,6,5,1,5,4,1,4,4,0,0,0,0,0,0,0,0,0,0,0,0,0
,,Asian,1,1,0,0,0,0,1,1,0,0,0,0,0,0,0,0,0,0,0,0,0
,Iowa,All Ethnicities,143,101,42,128,86,42,89,89,0,2,2,0,2,2,0,3,3,0,0,0,0
,,White,138,96,42,123,81,42,85,85,0,2,2,0,2,2,0,3,3,0,0,0,0
,,Black,3,3,0,3,3,0,3,3,0,0,0,0,0,0,0,0,0,0,0,0,0
,,Hispanic,1,1,0,1,1,0,0,0,0,0,0,0,0,0,0,0,0,0,0,0,0
,,Asian,1,1,0,1,1,0,1,1,0,0,0,0,0,0,0,0,0,0,0,0,0
,Kansas,All Ethnicities,184,169,15,126,112,14,160,159,1,0,0,0,1,1,0,6,6,0,0,0,0
,,White,164,149,15,115,101,14,141,140,1,0,0,0,1,1,0,5,5,0,0,0,0
,,Black,6,6,0,1,1,0,6,6,0,0,0,0,0,0,0,0,0,0,0,0,0
,,Hispanic,10,10,0,6,6,0,9,9,0,0,0,0,0,0,0,1,1,0,0,0,0
,,Asian,3,3,0,3,3,0,3,3,0,0,0,0,0,0,0,0,0,0,0,0,0
,,American Indian/Alaska Native,1,1,0,1,1,0,1,1,0,0,0,0,0,0,0,0,0,0,0,0,0
,Kentucky,All Ethnicities,121,100,21,106,85,21,86,86,0,2,2,0,3,3,0,2,2,0,0,0,0
,,White,113,92,21,101,80,21,80,80,0,2,2,0,3,3,0,2,2,0,0,0,0
,,Black,6,6,0,3,3,0,4,4,0,0,0,0,0,0,0,0,0,0,0,0,0
,,Asian,2,2,0,2,2,0,2,2,0,0,0,0,0,0,0,0,0,0,0,0,0
,Louisiana,All Ethnicities,184,165,19,124,105,19,151,151,0,0,0,0,2,2,0,5,5,0,0,0,0
,,White,136,119,17,96,79,17,110,110,0,0,0,0,2,2,0,3,3,0,0,0,0
,,Black,39,37,2,21,19,2,34,34,0,0,0,0,0,0,0,2,2,0,0,0,0
,,Hispanic,5,5,0,3,3,0,4,4,0,0,0,0,0,0,0,0,0,0,0,0,0
,,Asian,4,4,0,4,4,0,3,3,0,0,0,0,0,0,0,0,0,0,0,0,0
,Maine,All Ethnicities,95,64,31,86,55,31,51,51,0,0,0,0,1,1,0,1,1,0,0,0,0
,,White,95,64,31,86,55,31,51,51,0,0,0,0,1,1,0,1,1,0,0,0,0
,Maryland,All Ethnicities,537,429,108,466,359,107,356,355,1,0,0,0,1,1,0,16,16,0,0,0,0
,,White,379,285,94,341,248,93,230,229,1,0,0,0,1,1,0,11,11,0,0,0,0
,,Black,133,124,9,103,94,9,109,109,0,0,0,0,0,0,0,5,5,0,0,0,0
,,Hispanic,8,8,0,7,7,0,8,8,0,0,0,0,0,0,0,0,0,0,0,0,0
,,Asian,15,11,4,13,9,4,8,8,0,0,0,0,0,0,0,0,0,0,0,0,0
,,American Indian/Alaska Native,1,1,0,1,1,0,1,1,0,0,0,0,0,0,0,0,0,0,0,0,0
,,Multiracial,1,0,1,1,0,1,0,0,0,0,0,0,0,0,0,0,0,0,0,0,0
,Massachusetts,All Ethnicities,409,319,90,362,273,89,263,262,1,1,1,0,1,1,0,13,13,0,0,0,0
,,White,367,283,84,328,245,83,230,229,1,1,1,0,1,1,0,13,13,0,0,0,0
,,Black,19,17,2,15,13,2,16,16,0,0,0,0,0,0,0,0,0,0,0,0,0
,,Hispanic,13,11,2,11,9,2,9,9,0,0,0,0,0,0,0,0,0,0,0,0,0
,,Asian,9,7,2,7,5,2,7,7,0,0,0,0,0,0,0,0,0,0,0,0,0
,,Multiracial,1,1,0,1,1,0,1,1,0,0,0,0,0,0,0,0,0,0,0,0,0
,Michigan,All Ethnicities,549,446,103,459,356,103,344,344,0,3,3,0,1,1,0,34,34,0,0,0,0
,,White,486,392,94,413,319,94,298,298,0,2,2,0,1,1,0,29,29,0,0,0,0
,,,,,,,,,,,,,,,,,,,,,,,
,,,,,,,,,,,,,,,,,,,,,,,
,,Black,47,40,7,32,25,7,34,34,0,0,0,0,0,0,0,1,1,0,0,0,0
,,Hispanic,9,8,1,8,7,1,7,7,0,0,0,0,0,0,0,1,1,0,0,0,0
,,Asian,5,5,0,4,4,0,4,4,0,1,1,0,0,0,0,3,3,0,0,0,0
,,Pacific Islander,1,1,0,1,1,0,1,1,0,0,0,0,0,0,0,0,0,0,0,0,0
,,Multiracial,1,0,1,1,0,1,0,0,0,0,0,0,0,0,0,0,0,0,0,0,0
,Minnesota,All Ethnicities,386,275,111,325,216,109,242,240,2,4,4,0,7,7,0,5,5,0,0,0,0
,,White,378,269,109,320,213,107,236,234,2,4,4,0,7,7,0,5,5,0,0,0,0
,,Black,4,3,1,2,1,1,3,3,0,0,0,0,0,0,0,0,0,0,0,0,0
,,Hispanic,3,2,1,3,2,1,2,2,0,0,0,0,0,0,0,0,0,0,0,0,0
,,Asian,1,1,0,0,0,0,1,1,0,0,0,0,0,0,0,0,0,0,0,0,0
,Mississippi,All Ethnicities,139,126,13,108,95,13,106,106,0,0,0,0,0,0,0,0,0,0,0,0,0
,,White,110,98,12,87,75,12,79,79,0,0,0,0,0,0,0,0,0,0,0,0,0
,,Black,27,26,1,19,18,1,25,25,0,0,0,0,0,0,0,0,0,0,0,0,0
,,Asian,1,1,0,1,1,0,1,1,0,0,0,0,0,0,0,0,0,0,0,0,0
,,American Indian/Alaska Native,1,1,0,1,1,0,1,1,0,0,0,0,0,0,0,0,0,0,0,0,0
,Missouri,All Ethnicities,460,413,47,293,246,47,393,393,0,1,1,0,5,5,0,15,15,0,0,0,0
,,White,398,353,45,267,222,45,335,335,0,1,1,0,5,5,0,12,12,0,0,0,0
,,Black,51,50,1,22,21,1,49,49,0,0,0,0,0,0,0,3,3,0,0,0,0
,,Hispanic,4,4,0,0,0,0,4,4,0,0,0,0,0,0,0,0,0,0,0,0,0
,,Asian,5,4,1,3,2,1,3,3,0,0,0,0,0,0,0,0,0,0,0,0,0
,,American Indian/Alaska Native,1,1,0,0,0,0,1,1,0,0,0,0,0,0,0,0,0,0,0,0,0
,,Pacific Islander,1,1,0,1,1,0,1,1,0,0,0,0,0,0,0,0,0,0,0,0,0
,Montana,All Ethnicities,31,21,10,26,16,10,16,16,0,0,0,0,1,1,0,2,2,0,0,0,0
,,White,30,20,10,26,16,10,15,15,0,0,0,0,1,1,0,2,2,0,0,0,0
,,Hispanic,1,1,0,0,0,0,1,1,0,0,0,0,0,0,0,0,0,0,0,0,0
,Nebraska,All Ethnicities,83,72,11,69,59,10,64,63,1,1,1,0,1,1,0,2,2,0,0,0,0
,,White,71,60,11,59,49,10,53,52,1,1,1,0,1,1,0,2,2,0,0,0,0
,,Black,4,4,0,3,3,0,4,4,0,0,0,0,0,0,0,0,0,0,0,0,0
,,Hispanic,5,5,0,4,4,0,5,5,0,0,0,0,0,0,0,0,0,0,0,0,0
,,Asian,3,3,0,3,3,0,2,2,0,0,0,0,0,0,0,0,0,0,0,0,0
,Nevada,All Ethnicities,162,145,17,132,115,17,132,132,0,1,1,0,1,1,0,8,8,0,0,0,0
,,White,123,109,14,106,92,14,100,100,0,1,1,0,1,1,0,4,4,0,0,0,0
,,Black,9,9,0,6,6,0,9,9,0,0,0,0,0,0,0,0,0,0,0,0,0
,,Hispanic,12,11,1,9,8,1,8,8,0,0,0,0,0,0,0,0,0,0,0,0,0
,,Asian,16,14,2,10,8,2,13,13,0,0,0,0,0,0,0,3,3,0,0,0,0
,,Pacific Islander,1,1,0,0,0,0,1,1,0,0,0,0,0,0,0,0,0,0,0,0,0
,,Multiracial,1,1,0,1,1,0,1,1,0,0,0,0,0,0,0,1,1,0,0,0,0
,New Hampshire,All Ethnicities,80,58,22,72,50,22,44,44,0,0,0,0,0,0,0,2,2,0,0,0,0
,,White,76,54,22,69,47,22,41,41,0,0,0,0,0,0,0,2,2,0,0,0,0
,,Hispanic,3,3,0,2,2,0,3,3,0,0,0,0,0,0,0,0,0,0,0,0,0
,,Asian,1,1,0,1,1,0,0,0,0,0,0,0,0,0,0,0,0,0,0,0,0
,,,,,,,,,,,,,,,,,,,,,,,
,,,,,,,,,,,,,,,,,,,,,,,
,New Jersey,All Ethnicities,633,495,138,559,423,136,423,421,2,3,3,0,2,2,0,7,7,0,0,0,0
,,White,477,361,116,428,314,114,305,303,2,3,3,0,2,2,0,3,3,0,0,0,0
,,Black,62,57,5,50,45,5,52,52,0,0,0,0,0,0,0,2,2,0,0,0,0
,,Hispanic,51,44,7,44,37,7,36,36,0,0,0,0,0,0,0,1,1,0,0,0,0
,,Asian,42,32,10,36,26,10,29,29,0,0,0,0,0,0,0,1,1,0,0,0,0
,,Multiracial,1,1,0,1,1,0,1,1,0,0,0,0,0,0,0,0,0,0,0,0,0
,New Mexico,All Ethnicities,91,71,20,77,57,20,62,62,0,0,0,0,1,1,0,2,2,0,0,0,0
,,White,59,42,17,49,32,17,38,38,0,0,0,0,1,1,0,1,1,0,0,0,0
,,Black,6,6,0,5,5,0,6,6,0,0,0,0,0,0,0,1,1,0,0,0,0
,,Hispanic,24,23,1,21,20,1,18,18,0,0,0,0,0,0,0,0,0,0,0,0,0
,,Asian,1,0,1,1,0,1,0,0,0,0,0,0,0,0,0,0,0,0,0,0,0
,,American Indian/Alaska Native,1,0,1,1,0,1,0,0,0,0,0,0,0,0,0,0,0,0,0,0,0
,New York,All Ethnicities,1748,1487,261,1109,852,257,1362,1358,4,4,4,0,6,6,0,16,16,0,0,0,0
,,White,1174,959,215,804,593,211,875,871,4,3,3,0,6,6,0,11,11,0,0,0,0
,,Black,253,243,10,105,95,10,230,230,0,1,1,0,0,0,0,2,2,0,0,0,0
,,Hispanic,237,214,23,141,118,23,190,190,0,0,0,0,0,0,0,3,3,0,0,0,0
,,Asian,66,57,9,48,39,9,55,55,0,0,0,0,0,0,0,0,0,0,0,0,0
,,Pacific Islander,5,3,2,4,2,2,3,3,0,0,0,0,0,0,0,0,0,0,0,0,0
,,Multiracial,13,11,2,7,5,2,9,9,0,0,0,0,0,0,0,0,0,0,0,0,0
,North Carolina,All Ethnicities,477,404,73,384,311,73,330,330,0,7,7,0,3,3,0,24,24,0,0,0,0
,,White,386,317,69,317,248,69,256,256,0,7,7,0,3,3,0,20,20,0,0,0,0
,,Black,76,72,4,53,49,4,60,60,0,0,0,0,0,0,0,1,1,0,0,0,0
,,Hispanic,5,5,0,4,4,0,5,5,0,0,0,0,0,0,0,1,1,0,0,0,0
,,Asian,6,6,0,6,6,0,5,5,0,0,0,0,0,0,0,1,1,0,0,0,0
,,American Indian/Alaska Native,2,2,0,2,2,0,2,2,0,0,0,0,0,0,0,1,1,0,0,0,0
,,Multiracial,2,2,0,2,2,0,2,2,0,0,0,0,0,0,0,0,0,0,0,0,0
,North Dakota,All Ethnicities,44,33,11,35,24,11,28,28,0,0,0,0,1,1,0,0,0,0,0,0,0
,,White,44,33,11,35,24,11,28,28,0,0,0,0,1,1,0,0,0,0,0,0,0
,Ohio,All Ethnicities,627,529,98,538,440,98,433,433,0,10,10,0,1,1,0,21,21,0,0,0,0
,,White,552,461,91,483,392,91,371,371,0,10,10,0,1,1,0,18,18,0,0,0,0
,,Black,57,56,1,39,38,1,53,53,0,0,0,0,0,0,0,2,2,0,0,0,0
,,Hispanic,9,5,4,8,4,4,3,3,0,0,0,0,0,0,0,1,1,0,0,0,0
,,Asian,8,7,1,7,6,1,6,6,0,0,0,0,0,0,0,0,0,0,0,0,0
,,Pacific Islander,1,0,1,1,0,1,0,0,0,0,0,0,0,0,0,0,0,0,0,0,0
,Oklahoma,All Ethnicities,170,151,19,142,123,19,124,124,0,1,1,0,0,0,0,4,4,0,0,0,0
,,White,151,132,19,127,108,19,111,111,0,1,1,0,0,0,0,4,4,0,0,0,0
,,Black,10,10,0,7,7,0,8,8,0,0,0,0,0,0,0,0,0,0,0,0,0
,,Hispanic,2,2,0,2,2,0,1,1,0,0,0,0,0,0,0,0,0,0,0,0,0
,,Asian,1,1,0,1,1,0,1,1,0,0,0,0,0,0,0,0,0,0,0,0,0
,,American Indian/Alaska Native,5,5,0,4,4,0,2,2,0,0,0,0,0,0,0,0,0,0,0,0,0
,,Pacific Islander,1,1,0,1,1,0,1,1,0,0,0,0,0,0,0,0,0,0,0,0,0
,,,,,,,,,,,,,,,,,,,,,,,
,,,,,,,,,,,,,,,,,,,,,,,
,Oregon,All Ethnicities,122,72,50,119,69,50,67,67,0,0,0,0,1,1,0,2,2,0,0,0,0
,,White,115,66,49,112,63,49,62,62,0,0,0,0,1,1,0,1,1,0,0,0,0
,,Hispanic,4,4,0,4,4,0,4,4,0,0,0,0,0,0,0,1,1,0,0,0,0
,,Asian,3,2,1,3,2,1,1,1,0,0,0,0,0,0,0,0,0,0,0,0,0
,Pennsylvania,All Ethnicities,1611,1495,116,1327,1211,116,1289,1289,0,12,12,0,11,11,0,32,32,0,0,0,0
,,White,1410,1298,112,1186,1074,112,1121,1121,0,11,11,0,11,11,0,29,29,0,0,0,0
,,Black,136,133,3,91,88,3,117,117,0,1,1,0,0,0,0,1,1,0,0,0,0
,,Hispanic,42,41,1,30,29,1,31,31,0,0,0,0,0,0,0,1,1,0,0,0,0
,,Asian,20,20,0,17,17,0,17,17,0,0,0,0,0,0,0,1,1,0,0,0,0
,,American Indian/Alaska Native,1,1,0,1,1,0,1,1,0,0,0,0,0,0,0,0,0,0,0,0,0
,,Multiracial,2,2,0,2,2,0,2,2,0,0,0,0,0,0,0,0,0,0,0,0,0
,Puerto Rico,All Ethnicities,241,233,8,155,147,8,202,202,0,0,0,0,0,0,0,2,2,0,0,0,0
,,White,4,3,1,3,2,1,1,1,0,0,0,0,0,0,0,0,0,0,0,0,0
,,Hispanic,151,144,7,101,94,7,123,123,0,0,0,0,0,0,0,1,1,0,0,0,0
,,Multiracial,86,86,0,51,51,0,78,78,0,0,0,0,0,0,0,1,1,0,0,0,0
,Rhode Island,All Ethnicities,44,35,9,38,29,9,27,27,0,0,0,0,0,0,0,1,1,0,0,0,0
,,White,42,33,9,37,28,9,25,25,0,0,0,0,0,0,0,1,1,0,0,0,0
,,Hispanic,2,2,0,1,1,0,2,2,0,0,0,0,0,0,0,0,0,0,0,0,0
,South Carolina,All Ethnicities,294,264,30,244,214,30,244,244,0,3,3,0,1,1,0,10,10,0,0,0,0
,,White,243,213,30,211,181,30,195,195,0,3,3,0,1,1,0,8,8,0,0,0,0
,,Black,49,49,0,31,31,0,47,47,0,0,0,0,0,0,0,2,2,0,0,0,0
,,Hispanic,1,1,0,1,1,0,1,1,0,0,0,0,0,0,0,0,0,0,0,0,0
,,Multiracial,1,1,0,1,1,0,1,1,0,0,0,0,0,0,0,0,0,0,0,0,0
,South Dakota,All Ethnicities,55,43,12,49,37,12,42,42,0,1,1,0,3,3,0,3,3,0,1,1,0
,,White,53,41,12,48,36,12,40,40,0,1,1,0,3,3,0,3,3,0,1,1,0
,,Asian,1,1,0,1,1,0,1,1,0,0,0,0,0,0,0,0,0,0,0,0,0
,,American Indian/Alaska Native,1,1,0,0,0,0,1,1,0,0,0,0,0,0,0,0,0,0,0,0,0
,State unassigned,All Ethnicities,261,195,66,227,162,65,147,147,0,2,2,0,1,1,0,6,5,1,0,0,0
,,White,149,118,31,136,106,30,82,82,0,1,1,0,0,0,0,3,2,1,0,0,0
,,Black,22,19,3,17,14,3,17,17,0,0,0,0,0,0,0,0,0,0,0,0,0
,,Hispanic,41,32,9,33,24,9,23,23,0,0,0,0,0,0,0,2,2,0,0,0,0
,,Unknown,9,8,1,7,6,1,7,7,0,1,1,0,0,0,0,0,0,0,0,0,0
,,Asian,36,15,21,33,12,21,15,15,0,0,0,0,1,1,0,1,1,0,0,0,0
,,Pacific Islander,3,3,0,0,0,0,3,3,0,0,0,0,0,0,0,0,0,0,0,0,0
,,Multiracial,1,0,1,1,0,1,0,0,0,0,0,0,0,0,0,0,0,0,0,0,0
,Tennessee,All Ethnicities,368,333,35,304,269,35,298,298,0,3,3,0,1,1,0,2,2,0,0,0,0
,,White,324,291,33,269,236,33,261,261,0,3,3,0,1,1,0,1,1,0,0,0,0
,,Black,37,35,2,28,26,2,31,31,0,0,0,0,0,0,0,1,1,0,0,0,0
,,Hispanic,5,5,0,5,5,0,4,4,0,0,0,0,0,0,0,0,0,0,0,0,0
,,Asian,2,2,0,2,2,0,2,2,0,0,0,0,0,0,0,0,0,0,0,0,0
,Texas,All Ethnicities,1181,1017,164,739,577,162,880,878,2,7,7,0,2,2,0,16,16,0,0,0,0
,,,,,,,,,,,,,,,,,,,,,,,
,,,,,,,,,,,,,,,,,,,,,,,
,,White,856,718,138,551,414,137,617,616,1,7,7,0,2,2,0,8,8,0,0,0,0
,,Black,102,99,3,44,41,3,89,89,0,0,0,0,0,0,0,2,2,0,0,0,0
,,Hispanic,186,166,20,122,103,19,145,144,1,0,0,0,0,0,0,5,5,0,0,0,0
,,Unknown,2,2,0,2,2,0,0,0,0,0,0,0,0,0,0,0,0,0,0,0,0
,,Asian,31,30,1,17,16,1,27,27,0,0,0,0,0,0,0,1,1,0,0,0,0
,,Multiracial,4,2,2,3,1,2,2,2,0,0,0,0,0,0,0,0,0,0,0,0,0
,Utah,All Ethnicities,65,49,16,55,39,16,48,48,0,1,1,0,0,0,0,0,0,0,0,0,0
,,White,64,49,15,54,39,15,48,48,0,1,1,0,0,0,0,0,0,0,0,0,0
,,Hispanic,1,0,1,1,0,1,0,0,0,0,0,0,0,0,0,0,0,0,0,0,0
,Vermont,All Ethnicities,42,38,4,38,34,4,34,34,0,0,0,0,0,0,0,0,0,0,0,0,0
,,White,42,38,4,38,34,4,34,34,0,0,0,0,0,0,0,0,0,0,0,0,0
,Virginia,All Ethnicities,479,393,86,417,332,85,335,334,1,4,4,0,1,1,0,11,11,0,1,1,0
,,White,370,291,79,327,249,78,247,246,1,3,3,0,0,0,0,9,9,0,1,1,0
,,Black,74,70,4,61,57,4,58,58,0,0,0,0,0,0,0,2,2,0,0,0,0
,,Hispanic,10,9,1,9,8,1,9,9,0,1,1,0,0,0,0,0,0,0,0,0,0
,,Asian,23,22,1,18,17,1,20,20,0,0,0,0,1,1,0,0,0,0,0,0,0
,,American Indian/Alaska Native,2,1,1,2,1,1,1,1,0,0,0,0,0,0,0,0,0,0,0,0,0
,Washington,All Ethnicities,220,148,72,199,127,72,120,120,0,0,0,0,1,1,0,3,3,0,0,0,0
,,White,205,136,69,185,116,69,111,111,0,0,0,0,1,1,0,2,2,0,0,0,0
,,Black,3,3,0,2,2,0,3,3,0,0,0,0,0,0,0,0,0,0,0,0,0
,,Hispanic,4,3,1,4,3,1,3,3,0,0,0,0,0,0,0,1,1,0,0,0,0
,,Asian,7,5,2,7,5,2,2,2,0,0,0,0,0,0,0,0,0,0,0,0,0
,,American Indian/Alaska Native,1,1,0,1,1,0,1,1,0,0,0,0,0,0,0,0,0,0,0,0,0
,West Virginia,All Ethnicities,151,133,18,122,105,17,120,119,1,0,0,0,1,1,0,3,3,0,0,0,0
,,White,145,128,17,117,101,16,115,114,1,0,0,0,1,1,0,3,3,0,0,0,0
,,Black,4,3,1,4,3,1,3,3,0,0,0,0,0,0,0,0,0,0,0,0,0
,,Hispanic,2,2,0,1,1,0,2,2,0,0,0,0,0,0,0,0,0,0,0,0,0
,Wisconsin,All Ethnicities,457,369,88,385,297,88,300,300,0,6,6,0,2,2,0,9,9,0,0,0,0
,,White,433,350,83,368,285,83,284,284,0,6,6,0,2,2,0,9,9,0,0,0,0
,,Black,13,10,3,6,3,3,10,10,0,0,0,0,0,0,0,0,0,0,0,0,0
,,Hispanic,7,5,2,7,5,2,3,3,0,0,0,0,0,0,0,0,0,0,0,0,0
,,Asian,4,4,0,4,4,0,3,3,0,0,0,0,0,0,0,0,0,0,0,0,0
,Wyoming,All Ethnicities,23,18,5,21,16,5,17,17,0,1,1,0,1,1,0,0,0,0,0,0,0
,,White,23,18,5,21,16,5,17,17,0,1,1,0,1,1,0,0,0,0,0,0,0
Unknown,All Donor States of Residence,All Ethnicities,25,2,23,11,0,11,14,2,12,1,1,0,0,0,0,0,0,0,0,0,0
,,White,11,1,10,5,0,5,6,1,5,0,0,0,0,0,0,0,0,0,0,0,0
,,Black,2,0,2,0,0,0,2,0,2,0,0,0,0,0,0,0,0,0,0,0,0
,,Hispanic,7,1,6,2,0,2,5,1,4,1,1,0,0,0,0,0,0,0,0,0,0
,,Unknown,4,0,4,4,0,4,0,0,0,0,0,0,0,0,0,0,0,0,0,0,0
,,Asian,1,0,1,0,0,0,1,0,1,0,0,0,0,0,0,0,0,0,0,0,0
,Alabama,All Ethnicities,1,0,1,0,0,0,1,0,1,0,0,0,0,0,0,0,0,0,0,0,0
,,,,,,,,,,,,,,,,,,,,,,,
,,,,,,,,,,,,,,,,,,,,,,,
,,White,1,0,1,0,0,0,1,0,1,0,0,0,0,0,0,0,0,0,0,0,0
,California,All Ethnicities,1,0,1,0,0,0,1,0,1,0,0,0,0,0,0,0,0,0,0,0,0
,,Asian,1,0,1,0,0,0,1,0,1,0,0,0,0,0,0,0,0,0,0,0,0
,Maryland,All Ethnicities,1,0,1,0,0,0,1,0,1,0,0,0,0,0,0,0,0,0,0,0,0
,,Black,1,0,1,0,0,0,1,0,1,0,0,0,0,0,0,0,0,0,0,0,0
,Missouri,All Ethnicities,1,0,1,0,0,0,1,0,1,0,0,0,0,0,0,0,0,0,0,0,0
,,Black,1,0,1,0,0,0,1,0,1,0,0,0,0,0,0,0,0,0,0,0,0
,New York,All Ethnicities,2,0,2,0,0,0,2,0,2,0,0,0,0,0,0,0,0,0,0,0,0
,,White,2,0,2,0,0,0,2,0,2,0,0,0,0,0,0,0,0,0,0,0,0
,North Carolina,All Ethnicities,1,1,0,0,0,0,1,1,0,0,0,0,0,0,0,0,0,0,0,0,0
,,White,1,1,0,0,0,0,1,1,0,0,0,0,0,0,0,0,0,0,0,0,0
,State unassigned,All Ethnicities,12,1,11,9,0,9,3,1,2,1,1,0,0,0,0,0,0,0,0,0,0
,,White,5,0,5,3,0,3,2,0,2,0,0,0,0,0,0,0,0,0,0,0,0
,,Hispanic,3,1,2,2,0,2,1,1,0,1,1,0,0,0,0,0,0,0,0,0,0
,,Unknown,4,0,4,4,0,4,0,0,0,0,0,0,0,0,0,0,0,0,0,0,0
,Texas,All Ethnicities,2,0,2,2,0,2,0,0,0,0,0,0,0,0,0,0,0,0,0,0,0
,,White,2,0,2,2,0,2,0,0,0,0,0,0,0,0,0,0,0,0,0,0,0
,Virginia,All Ethnicities,4,0,4,0,0,0,4,0,4,0,0,0,0,0,0,0,0,0,0,0,0
,,Hispanic,4,0,4,0,0,0,4,0,4,0,0,0,0,0,0,0,0,0,0,0,0
