Donor Type,Donor Age,Donor State of Residence,All Donors - All Genders,All Donors - Male,All Donors - Female,All Donors - Unknown,Kidney - All Genders,Kidney - Male,Kidney - Female,Kidney - Unknown,Liver - All Genders,Liver - Male,Liver - Female,Liver - Unknown,Heart - All Genders,Heart - Male,Heart - Female,Heart - Unknown,Pancreas - All Genders,Pancreas - Male,Pancreas - Female,Pancreas - Unknown,Lung - All Genders,Lung - Male,Lung - Female,Lung - Unknown,Intestine - All Genders,Intestine - Male,Intestine - Female,Intestine - Unknown
All Donor Types,All Ages,All Donor States of Residence,387089,199626,187462,1,360646,184762,175883,1,187160,111108,76052,0,78109,53411,24698,0,46574,30911,15663,0,39849,24061,15788,0,3430,2011,1419,0
,,Alabama,6338,3297,3041,0,6014,3096,2918,0,3111,1880,1231,0,1193,854,339,0,603,433,170,0,572,379,193,0,36,22,14,0
,,Alaska,1008,556,452,0,979,537,442,0,499,321,178,0,210,165,45,0,150,121,29,0,129,86,43,0,1,1,0,0
,,Arizona,7007,3627,3380,0,6666,3438,3228,0,3242,2018,1224,0,1341,955,386,0,687,474,213,0,754,483,271,0,45,34,11,0
,,Arkansas,3121,1629,1492,0,2938,1524,1414,0,1766,1035,731,0,811,565,246,0,419,278,141,0,372,196,176,0,56,33,23,0
,,California,39248,20681,18567,0,36774,19275,17499,0,18905,11616,7289,0,8565,6009,2556,0,4222,2908,1314,0,4479,2787,1692,0,158,87,71,0
,,Colorado,5736,2950,2786,0,5354,2742,2612,0,2596,1531,1065,0,1210,827,383,0,756,476,280,0,494,291,203,0,42,23,19,0
,,Connecticut,4061,2062,1999,0,3821,1929,1892,0,1664,1003,661,0,725,511,214,0,354,242,112,0,273,187,86,0,21,13,8,0
,,Delaware,1499,790,709,0,1386,723,663,0,857,503,354,0,328,222,106,0,204,139,65,0,199,126,73,0,13,10,3,0
,,District of Columbia,1034,562,472,0,955,516,439,0,475,291,184,0,185,138,47,0,156,116,40,0,112,67,45,0,8,6,2,0
,,Florida,20774,11142,9632,0,19064,10181,8883,0,11974,7148,4826,0,4588,3129,1459,0,2682,1805,877,0,2408,1392,1016,0,388,233,155,0
,,Georgia,10557,5230,5327,0,9581,4659,4922,0,5562,3186,2376,0,2367,1601,766,0,981,692,289,0,1172,683,489,0,117,65,52,0
,,Hawaii,1303,732,571,0,1256,709,547,0,594,382,212,0,69,56,13,0,109,84,25,0,32,15,17,0,1,1,0,0
,,Idaho,1676,869,807,0,1601,825,776,0,779,484,295,0,374,257,117,0,201,138,63,0,148,99,49,0,15,6,9,0
,,Illinois,17991,9401,8590,0,16603,8634,7969,0,7906,4733,3173,0,3052,2090,962,0,2659,1717,942,0,1852,1144,708,0,159,100,59,0
,,Indiana,7895,4048,3847,0,7467,3803,3664,0,4128,2436,1692,0,1950,1341,609,0,1218,796,422,0,1010,599,411,0,204,123,81,0
,,Iowa,3825,1926,1899,0,3666,1840,1826,0,1674,981,693,0,719,466,253,0,561,355,206,0,353,192,161,0,39,16,23,0
,,Kansas,3656,2011,1645,0,3431,1880,1551,0,2141,1303,838,0,937,650,287,0,659,431,228,0,501,313,188,0,51,30,21,0
,,Kentucky,4756,2495,2261,0,4521,2340,2181,0,2486,1520,966,0,1091,753,338,0,701,458,243,0,542,336,206,0,47,23,24,0
,,Louisiana,5950,3242,2708,0,5436,2952,2484,0,3652,2229,1423,0,1498,1070,428,0,984,680,304,0,822,514,308,0,77,47,30,0
,,Maine,1770,919,851,0,1649,851,798,0,783,479,304,0,336,233,103,0,208,132,76,0,136,85,51,0,17,8,9,0
,,Maryland,8941,4398,4543,0,8304,4023,4281,0,4035,2384,1651,0,1436,966,470,0,1162,774,388,0,1007,612,395,0,54,29,25,0
,,Massachusetts,7947,3995,3952,0,7368,3671,3697,0,3063,1804,1259,0,1242,822,420,0,615,416,199,0,536,325,211,0,34,20,14,0
,,Michigan,14393,7209,7184,0,13598,6782,6816,0,6036,3525,2511,0,2549,1689,860,0,1425,947,478,0,1555,889,666,0,154,87,67,0
,,Minnesota,8474,4143,4331,0,8017,3902,4115,0,3091,1785,1306,0,1307,829,478,0,1403,857,546,0,697,410,287,0,90,54,36,0
,,Mississippi,3136,1633,1503,0,2933,1518,1415,0,1726,1014,712,0,721,479,242,0,395,258,137,0,316,198,118,0,63,36,27,0
,,Missouri,7950,4199,3751,0,7236,3799,3437,0,4631,2714,1917,0,1863,1247,616,0,1127,735,392,0,1218,745,473,0,102,59,43,0
,,Montana,1236,614,622,0,1178,579,599,0,577,340,237,0,295,202,93,0,171,115,56,0,104,59,45,0,11,8,3,0
,,Nebraska,2312,1134,1178,0,2183,1070,1113,0,1139,626,513,0,443,282,161,0,422,254,168,0,231,131,100,0,35,16,19,0
,,Nevada,2972,1564,1408,0,2769,1440,1329,0,1687,964,723,0,706,461,245,0,310,212,98,0,344,192,152,0,21,14,7,0
,,New Hampshire,1687,833,854,0,1575,769,806,0,664,391,273,0,270,173,97,0,157,99,58,0,140,71,69,0,3,3,0,0
,,New Jersey,11172,5424,5748,0,10535,5075,5460,0,4616,2625,1991,0,1803,1155,648,0,1096,684,412,0,784,450,334,0,43,23,20,0
,,New Mexico,2328,1222,1106,0,2199,1150,1049,0,1184,688,496,0,543,380,163,0,201,129,72,0,194,121,73,0,19,14,5,0
,,New York,22604,11283,11321,0,20099,9969,10130,0,9863,5566,4297,0,3344,2240,1104,0,1763,1120,643,0,1127,644,483,0,140,84,56,0
,,North Carolina,10187,5299,4888,0,9526,4908,4618,0,5121,3014,2107,0,2438,1662,776,0,1520,1006,514,0,1328,810,518,0,127,73,54,0
,,North Dakota,1029,497,532,0,985,476,509,0,399,229,170,0,171,119,52,0,182,115,67,0,76,39,37,0,14,8,6,0
,,Ohio,15946,8032,7914,0,15033,7522,7511,0,7422,4361,3061,0,3000,1993,1007,0,2377,1544,833,0,1675,958,717,0,137,83,54,0
,,Oklahoma,4334,2341,1993,0,4076,2184,1892,0,2430,1430,1000,0,1094,729,365,0,392,276,116,0,454,293,161,0,31,15,16,0
,,Oregon,3813,1892,1921,0,3681,1817,1864,0,1709,995,714,0,765,504,261,0,414,282,132,0,272,159,113,0,10,7,3,0
,,Pennsylvania,19932,10562,9370,0,18342,9665,8677,0,11001,6496,4505,0,4008,2724,1284,0,2693,1729,964,0,2271,1383,888,0,178,105,73,0
,,Puerto Rico,2737,1500,1237,0,2451,1328,1123,0,1567,959,608,0,355,287,68,0,245,184,61,0,246,174,72,0,29,20,9,0
,,Rhode Island,1229,577,652,0,1154,534,620,0,393,229,164,0,178,112,66,0,102,63,39,0,62,30,32,0,4,3,1,0
,,,,,,,,,,,,,,,,,,,,,,,,,,,,,,
,,,,,,,,,,,,,,,,,,,,,,,,,,,,,,
,,South Carolina,5383,2839,2544,0,5086,2671,2415,0,3210,1918,1292,0,1413,1016,397,0,760,542,218,0,736,483,253,0,51,33,18,0
,,South Dakota,1111,558,553,0,1066,531,535,0,505,297,208,0,202,130,72,0,233,139,94,0,124,70,54,0,16,10,6,0
,,State unassigned,7828,4233,3594,1,7280,3915,3364,1,2596,1639,957,0,1279,937,342,0,640,457,183,0,477,316,161,0,26,11,15,0
,,Tennessee,8081,4151,3930,0,7535,3831,3704,0,4480,2600,1880,0,2090,1427,663,0,1156,766,390,0,974,588,386,0,129,70,59,0
,,Texas,28137,14538,13599,0,26064,13368,12696,0,14257,8535,5722,0,6831,4761,2070,0,2616,1826,790,0,3483,2135,1348,0,209,130,79,0
,,Utah,3496,1831,1665,0,3313,1737,1576,0,1426,861,565,0,703,459,244,0,375,249,126,0,259,156,103,0,13,8,5,0
,,Vermont,798,389,409,0,746,359,387,0,350,202,148,0,138,89,49,0,85,55,30,0,62,36,26,0,3,1,2,0
,,Virginia,10007,5058,4949,0,9398,4706,4692,0,4343,2574,1769,0,1762,1192,570,0,916,610,306,0,922,560,362,0,78,39,39,0
,,Washington,6425,3192,3233,0,6193,3069,3124,0,2805,1675,1130,0,1217,805,412,0,723,474,249,0,602,343,259,0,26,13,13,0
,,West Virginia,2429,1218,1211,0,2228,1109,1119,0,1445,805,640,0,495,329,166,0,377,243,134,0,271,158,113,0,42,27,15,0
,,Wisconsin,9144,4722,4422,0,8686,4479,4207,0,4235,2553,1682,0,1715,1179,536,0,1895,1194,701,0,867,502,365,0,42,26,16,0
,,Wyoming,686,377,309,0,647,352,295,0,360,231,129,0,184,140,44,0,112,82,30,0,75,47,28,0,1,1,0,0
,< 1 Year,All Donor States of Residence,3386,1918,1468,0,1856,1085,771,0,2339,1314,1025,0,2337,1319,1018,0,426,242,184,0,156,97,59,0,682,375,307,0
,,Alabama,60,35,25,0,32,20,12,0,34,22,12,0,40,23,17,0,6,3,3,0,1,1,0,0,7,4,3,0
,,Alaska,8,2,6,0,7,2,5,0,6,2,4,0,3,2,1,0,1,1,0,0,0,0,0,0,1,1,0,0
,,Arizona,52,31,21,0,39,22,17,0,32,19,13,0,33,19,14,0,3,3,0,0,4,2,2,0,4,3,1,0
,,Arkansas,42,26,16,0,20,14,6,0,31,20,11,0,32,19,13,0,10,5,5,0,0,0,0,0,12,8,4,0
,,California,334,182,152,0,202,113,89,0,216,117,99,0,241,122,119,0,19,9,10,0,12,8,4,0,34,18,16,0
,,Colorado,51,29,22,0,23,12,11,0,31,19,12,0,37,22,15,0,6,3,3,0,0,0,0,0,10,5,5,0
,,Connecticut,23,17,6,0,18,13,5,0,18,14,4,0,16,12,4,0,2,2,0,0,1,0,1,0,3,3,0,0
,,Delaware,8,4,4,0,5,2,3,0,7,4,3,0,5,3,2,0,0,0,0,0,0,0,0,0,1,1,0,0
,,District of Columbia,8,5,3,0,6,4,2,0,8,5,3,0,6,3,3,0,1,1,0,0,1,1,0,0,1,1,0,0
,,Florida,224,128,96,0,98,59,39,0,170,97,73,0,149,79,70,0,54,35,19,0,12,4,8,0,67,40,27,0
,,Georgia,110,63,47,0,48,27,21,0,77,45,32,0,92,53,39,0,18,12,6,0,4,3,1,0,31,18,13,0
,,Hawaii,7,6,1,0,4,4,0,0,4,3,1,0,3,3,0,0,1,1,0,0,0,0,0,0,1,1,0,0
,,Idaho,20,9,11,0,12,4,8,0,13,4,9,0,13,5,8,0,3,0,3,0,1,1,0,0,5,0,5,0
,,Illinois,170,100,70,0,91,59,32,0,116,70,46,0,104,58,46,0,14,11,3,0,10,7,3,0,29,16,13,0
,,Indiana,75,46,29,0,41,26,15,0,54,32,22,0,58,37,21,0,17,12,5,0,4,3,1,0,20,12,8,0
,,Iowa,30,19,11,0,17,11,6,0,23,13,10,0,22,13,9,0,6,2,4,0,1,1,0,0,10,4,6,0
,,Kansas,53,26,27,0,31,17,14,0,34,15,19,0,35,14,21,0,7,5,2,0,1,1,0,0,15,6,9,0
,,Kentucky,50,28,22,0,27,18,9,0,45,27,18,0,40,23,17,0,8,3,5,0,0,0,0,0,14,6,8,0
,,Louisiana,54,28,26,0,23,17,6,0,45,21,24,0,40,24,16,0,12,4,8,0,3,2,1,0,17,7,10,0
,,Maine,8,2,6,0,6,2,4,0,7,1,6,0,5,1,4,0,7,1,6,0,1,0,1,0,7,1,6,0
,,Maryland,54,31,23,0,40,25,15,0,40,20,20,0,33,20,13,0,10,5,5,0,3,2,1,0,11,5,6,0
,,Massachusetts,32,23,9,0,17,12,5,0,21,14,7,0,20,14,6,0,2,1,1,0,2,1,1,0,9,5,4,0
,,Michigan,109,58,51,0,59,32,27,0,72,35,37,0,79,43,36,0,16,11,5,0,4,3,1,0,29,16,13,0
,,Minnesota,59,34,25,0,26,16,10,0,41,25,16,0,42,26,16,0,7,3,4,0,4,2,2,0,10,4,6,0
,,Mississippi,43,23,20,0,22,8,14,0,32,15,17,0,26,17,9,0,10,6,4,0,3,3,0,0,13,9,4,0
,,Missouri,80,40,40,0,39,17,22,0,51,25,26,0,53,25,28,0,12,5,7,0,6,4,2,0,20,11,9,0
,,Montana,14,11,3,0,7,4,3,0,11,8,3,0,12,11,1,0,2,1,1,0,0,0,0,0,4,3,1,0
,,Nebraska,24,11,13,0,8,5,3,0,19,8,11,0,13,7,6,0,4,2,2,0,2,2,0,0,7,2,5,0
,,,,,,,,,,,,,,,,,,,,,,,,,,,,,,
,,,,,,,,,,,,,,,,,,,,,,,,,,,,,,
,,Nevada,35,17,18,0,31,15,16,0,21,11,10,0,24,12,12,0,2,1,1,0,0,0,0,0,4,3,1,0
,,New Hampshire,5,1,4,0,3,1,2,0,5,1,4,0,2,0,2,0,0,0,0,0,1,1,0,0,0,0,0,0
,,New Jersey,69,33,36,0,44,16,28,0,43,23,20,0,47,23,24,0,6,2,4,0,5,4,1,0,11,7,4,0
,,New Mexico,26,17,9,0,13,10,3,0,21,12,9,0,19,12,7,0,3,1,2,0,1,0,1,0,3,2,1,0
,,New York,137,80,57,0,71,41,30,0,95,54,41,0,96,50,46,0,19,13,6,0,7,5,2,0,34,21,13,0
,,North Carolina,125,77,48,0,61,39,22,0,94,59,35,0,87,53,34,0,14,9,5,0,7,4,3,0,33,20,13,0
,,North Dakota,5,2,3,0,3,2,1,0,3,2,1,0,5,2,3,0,0,0,0,0,0,0,0,0,0,0,0,0
,,Ohio,111,61,50,0,58,36,22,0,76,43,33,0,79,45,34,0,14,7,7,0,8,5,3,0,21,12,9,0
,,Oklahoma,43,25,18,0,29,16,13,0,28,15,13,0,29,15,14,0,3,1,2,0,1,0,1,0,7,2,5,0
,,Oregon,31,17,14,0,16,10,6,0,18,9,9,0,22,11,11,0,2,1,1,0,1,1,0,0,3,2,1,0
,,Pennsylvania,155,96,59,0,92,56,36,0,100,60,40,0,93,58,35,0,15,7,8,0,11,6,5,0,25,12,13,0
,,Puerto Rico,9,6,3,0,7,5,2,0,7,4,3,0,6,5,1,0,0,0,0,0,0,0,0,0,0,0,0,0
,,Rhode Island,1,1,0,0,0,0,0,0,0,0,0,0,1,1,0,0,0,0,0,0,0,0,0,0,0,0,0,0
,,South Carolina,34,16,18,0,20,12,8,0,28,12,16,0,28,14,14,0,11,7,4,0,1,1,0,0,16,9,7,0
,,South Dakota,5,2,3,0,2,1,1,0,1,1,0,0,4,2,2,0,0,0,0,0,0,0,0,0,0,0,0,0
,,State unassigned,42,19,23,0,17,10,7,0,27,16,11,0,26,11,15,0,1,1,0,0,0,0,0,0,3,1,2,0
,,Tennessee,102,54,48,0,57,31,26,0,75,36,39,0,80,42,38,0,16,5,11,0,6,1,5,0,26,9,17,0
,,Texas,343,207,136,0,187,114,73,0,242,146,96,0,228,148,80,0,29,21,8,0,15,10,5,0,57,39,18,0
,,Utah,56,34,22,0,45,28,17,0,29,17,12,0,35,23,12,0,3,2,1,0,1,1,0,0,5,3,2,0
,,Vermont,4,3,1,0,2,1,1,0,4,3,1,0,1,1,0,0,1,1,0,0,0,0,0,0,0,0,0,0
,,Virginia,81,42,39,0,48,28,20,0,56,28,28,0,59,30,29,0,10,6,4,0,6,3,3,0,15,9,6,0
,,Washington,63,27,36,0,36,19,17,0,37,17,20,0,40,18,22,0,5,2,3,0,1,1,0,0,8,3,5,0
,,West Virginia,17,8,9,0,11,5,6,0,16,7,9,0,13,5,8,0,6,3,3,0,3,3,0,0,7,3,4,0
,,Wisconsin,75,51,24,0,31,21,10,0,51,36,15,0,53,36,17,0,8,5,3,0,1,0,1,0,12,8,4,0
,,Wyoming,10,5,5,0,4,3,1,0,4,2,2,0,8,4,4,0,0,0,0,0,0,0,0,0,0,0,0,0
,1-5 Years,All Donor States of Residence,6694,3902,2792,0,6183,3598,2585,0,5363,3115,2248,0,2956,1709,1247,0,541,331,210,0,301,165,136,0,789,458,331,0
,,Alabama,106,57,49,0,98,51,47,0,88,49,39,0,45,27,18,0,6,3,3,0,4,1,3,0,12,6,6,0
,,Alaska,27,17,10,0,25,16,9,0,20,13,7,0,7,6,1,0,1,1,0,0,0,0,0,0,0,0,0,0
,,Arizona,141,96,45,0,133,89,44,0,117,79,38,0,71,52,19,0,5,4,1,0,3,1,2,0,14,9,5,0
,,Arkansas,59,39,20,0,56,36,20,0,45,30,15,0,27,14,13,0,6,4,2,0,3,0,3,0,6,4,2,0
,,California,639,378,261,0,575,347,228,0,520,302,218,0,317,182,135,0,21,13,8,0,24,9,15,0,45,25,20,0
,,Colorado,75,48,27,0,64,40,24,0,57,33,24,0,32,23,9,0,3,1,2,0,2,2,0,0,9,7,2,0
,,Connecticut,43,23,20,0,41,22,19,0,32,14,18,0,15,7,8,0,3,3,0,0,4,3,1,0,7,4,3,0
,,Delaware,19,11,8,0,19,11,8,0,15,9,6,0,7,5,2,0,0,0,0,0,1,1,0,0,1,1,0,0
,,District of Columbia,7,5,2,0,7,5,2,0,5,4,1,0,3,2,1,0,1,1,0,0,0,0,0,0,0,0,0,0
,,Florida,487,303,184,0,452,281,171,0,411,253,158,0,195,115,80,0,89,57,32,0,16,10,6,0,86,59,27,0
,,Georgia,224,120,104,0,212,111,101,0,183,95,88,0,116,63,53,0,19,9,10,0,11,2,9,0,31,18,13,0
,,Hawaii,15,8,7,0,14,7,7,0,10,6,4,0,0,0,0,0,0,0,0,0,0,0,0,0,0,0,0,0
,,Idaho,59,37,22,0,57,36,21,0,46,29,17,0,26,17,9,0,0,0,0,0,3,2,1,0,1,1,0,0
,,Illinois,290,172,118,0,261,151,110,0,232,134,98,0,119,68,51,0,17,12,5,0,20,14,6,0,39,20,19,0
,,Indiana,159,92,67,0,151,89,62,0,133,77,56,0,68,40,28,0,27,16,11,0,12,6,6,0,24,14,10,0
,,,,,,,,,,,,,,,,,,,,,,,,,,,,,,
,,,,,,,,,,,,,,,,,,,,,,,,,,,,,,
,,Iowa,77,44,33,0,73,42,31,0,63,37,26,0,37,17,20,0,7,4,3,0,1,1,0,0,16,6,10,0
,,Kansas,97,48,49,0,85,41,44,0,76,40,36,0,45,20,25,0,8,3,5,0,4,1,3,0,15,10,5,0
,,Kentucky,96,59,37,0,88,54,34,0,76,46,30,0,41,25,16,0,13,9,4,0,2,1,1,0,17,8,9,0
,,Louisiana,136,85,51,0,124,78,46,0,119,73,46,0,66,41,25,0,20,12,8,0,7,3,4,0,20,11,9,0
,,Maine,19,8,11,0,18,8,10,0,17,8,9,0,13,6,7,0,1,0,1,0,0,0,0,0,2,1,1,0
,,Maryland,97,47,50,0,93,44,49,0,69,32,37,0,36,21,15,0,6,2,4,0,11,5,6,0,5,1,4,0
,,Massachusetts,54,30,24,0,51,29,22,0,41,23,18,0,20,12,8,0,3,2,1,0,3,0,3,0,5,4,1,0
,,Michigan,209,114,95,0,189,103,86,0,170,88,82,0,89,53,36,0,21,13,8,0,9,5,4,0,36,19,17,0
,,Minnesota,99,55,44,0,91,51,40,0,85,47,38,0,52,25,27,0,8,4,4,0,11,10,1,0,16,10,6,0
,,Mississippi,91,50,41,0,85,46,39,0,72,42,30,0,43,24,19,0,11,3,8,0,3,2,1,0,17,7,10,0
,,Missouri,157,78,79,0,137,66,71,0,134,66,68,0,83,40,43,0,19,7,12,0,14,6,8,0,25,12,13,0
,,Montana,22,7,15,0,20,6,14,0,20,7,13,0,14,4,10,0,2,1,1,0,0,0,0,0,3,2,1,0
,,Nebraska,47,27,20,0,41,24,17,0,41,25,16,0,20,14,6,0,6,3,3,0,2,2,0,0,8,4,4,0
,,Nevada,57,33,24,0,54,31,23,0,49,31,18,0,28,16,12,0,1,1,0,0,1,1,0,0,4,3,1,0
,,New Hampshire,7,4,3,0,7,4,3,0,7,4,3,0,3,1,2,0,0,0,0,0,0,0,0,0,0,0,0,0
,,New Jersey,166,88,78,0,153,80,73,0,118,66,52,0,72,40,32,0,7,6,1,0,9,4,5,0,14,8,6,0
,,New Mexico,47,27,20,0,43,25,18,0,40,24,16,0,19,16,3,0,4,1,3,0,4,2,2,0,1,1,0,0
,,New York,274,163,111,0,251,154,97,0,203,125,78,0,111,66,45,0,29,18,11,0,19,11,8,0,32,19,13,0
,,North Carolina,193,115,78,0,178,108,70,0,158,90,68,0,75,46,29,0,22,14,8,0,9,7,2,0,38,21,17,0
,,North Dakota,20,4,16,0,19,4,15,0,16,2,14,0,6,3,3,0,2,1,1,0,0,0,0,0,2,0,2,0
,,Ohio,232,144,88,0,213,132,81,0,182,113,69,0,90,56,34,0,18,13,5,0,10,3,7,0,24,15,9,0
,,Oklahoma,118,65,53,0,113,61,52,0,90,47,43,0,56,27,29,0,4,0,4,0,2,0,2,0,11,5,6,0
,,Oregon,75,44,31,0,68,39,29,0,62,39,23,0,38,20,18,0,2,2,0,0,0,0,0,0,2,2,0,0
,,Pennsylvania,284,180,104,0,274,173,101,0,220,136,84,0,107,61,46,0,20,12,8,0,21,9,12,0,26,13,13,0
,,Puerto Rico,33,22,11,0,33,22,11,0,24,17,7,0,4,3,1,0,2,2,0,0,0,0,0,0,4,2,2,0
,,Rhode Island,10,6,4,0,10,6,4,0,6,5,1,0,3,2,1,0,1,1,0,0,1,1,0,0,1,1,0,0
,,South Carolina,97,61,36,0,92,58,34,0,86,55,31,0,54,31,23,0,13,11,2,0,2,1,1,0,18,15,3,0
,,South Dakota,26,20,6,0,24,18,6,0,23,19,4,0,7,6,1,0,5,5,0,0,4,3,1,0,4,4,0,0
,,State unassigned,98,57,41,0,83,46,37,0,76,45,31,0,36,25,11,0,3,1,2,0,5,3,2,0,4,2,2,0
,,Tennessee,179,108,71,0,166,101,65,0,153,89,64,0,95,57,38,0,30,19,11,0,6,5,1,0,37,20,17,0
,,Texas,729,415,314,0,686,387,299,0,573,329,244,0,351,194,157,0,28,18,10,0,22,19,3,0,69,40,29,0
,,Utah,76,44,32,0,71,40,31,0,50,30,20,0,24,14,10,0,2,2,0,0,1,1,0,0,2,2,0,0
,,Vermont,7,4,3,0,7,4,3,0,6,4,2,0,4,2,2,0,1,1,0,0,0,0,0,0,1,1,0,0
,,Virginia,142,86,56,0,134,82,52,0,108,66,42,0,57,38,19,0,11,6,5,0,7,4,3,0,14,7,7,0
,,Washington,102,57,45,0,94,52,42,0,79,42,37,0,46,25,21,0,3,1,2,0,2,1,1,0,9,6,3,0
,,West Virginia,46,23,23,0,43,22,21,0,34,16,18,0,18,7,11,0,2,2,0,0,4,1,3,0,3,3,0,0
,,Wisconsin,111,69,42,0,94,61,33,0,91,56,35,0,39,27,12,0,8,7,1,0,2,2,0,0,9,5,4,0
,,Wyoming,14,5,9,0,13,4,9,0,12,4,8,0,6,3,3,0,0,0,0,0,0,0,0,0,0,0,0,0
,6-10 Years,All Donor States of Residence,4413,2686,1727,0,4306,2624,1682,0,3686,2250,1436,0,1709,1054,655,0,933,606,327,0,502,280,222,0,326,198,128,0
,,Alabama,83,44,39,0,81,44,37,0,71,36,35,0,28,15,13,0,8,4,4,0,7,4,3,0,6,4,2,0
,,Alaska,17,13,4,0,17,13,4,0,13,10,3,0,4,4,0,0,2,0,2,0,0,0,0,0,0,0,0,0
,,,,,,,,,,,,,,,,,,,,,,,,,,,,,,
,,,,,,,,,,,,,,,,,,,,,,,,,,,,,,
,,Arizona,83,57,26,0,80,56,24,0,73,50,23,0,26,18,8,0,10,7,3,0,5,5,0,0,8,7,1,0
,,Arkansas,43,22,21,0,42,22,20,0,35,19,16,0,21,12,9,0,9,4,5,0,5,2,3,0,3,0,3,0
,,California,405,257,148,0,390,250,140,0,352,227,125,0,175,111,64,0,77,59,18,0,51,29,22,0,20,13,7,0
,,Colorado,51,33,18,0,49,33,16,0,39,29,10,0,21,16,5,0,13,10,3,0,1,1,0,0,3,1,2,0
,,Connecticut,39,24,15,0,38,24,14,0,29,17,12,0,7,4,3,0,7,3,4,0,8,5,3,0,4,1,3,0
,,Delaware,17,8,9,0,17,8,9,0,12,5,7,0,2,1,1,0,3,1,2,0,2,1,1,0,0,0,0,0
,,District of Columbia,9,7,2,0,8,6,2,0,9,7,2,0,3,2,1,0,2,2,0,0,0,0,0,0,3,2,1,0
,,Florida,287,178,109,0,276,173,103,0,242,154,88,0,117,71,46,0,61,43,18,0,42,23,19,0,40,25,15,0
,,Georgia,156,99,57,0,155,99,56,0,124,78,46,0,81,51,30,0,18,13,5,0,23,14,9,0,16,9,7,0
,,Hawaii,16,11,5,0,15,10,5,0,12,9,3,0,0,0,0,0,0,0,0,0,0,0,0,0,0,0,0,0
,,Idaho,30,21,9,0,29,20,9,0,25,16,9,0,12,9,3,0,6,4,2,0,1,0,1,0,4,4,0,0
,,Illinois,177,111,66,0,174,108,66,0,151,91,60,0,63,36,27,0,56,33,23,0,25,10,15,0,9,5,4,0
,,Indiana,106,59,47,0,102,57,45,0,87,51,36,0,41,20,21,0,27,14,13,0,13,5,8,0,7,6,1,0
,,Iowa,48,25,23,0,48,25,23,0,33,18,15,0,16,11,5,0,14,10,4,0,5,2,3,0,1,1,0,0
,,Kansas,67,41,26,0,66,41,25,0,52,34,18,0,28,16,12,0,11,6,5,0,9,5,4,0,3,3,0,0
,,Kentucky,64,37,27,0,62,36,26,0,52,31,21,0,22,15,7,0,14,9,5,0,6,3,3,0,4,1,3,0
,,Louisiana,98,58,40,0,95,56,39,0,87,50,37,0,40,27,13,0,26,14,12,0,13,9,4,0,7,6,1,0
,,Maine,20,12,8,0,20,12,8,0,15,9,6,0,8,4,4,0,0,0,0,0,3,2,1,0,2,1,1,0
,,Maryland,63,37,26,0,61,36,25,0,50,29,21,0,22,14,8,0,20,11,9,0,10,5,5,0,2,1,1,0
,,Massachusetts,39,17,22,0,39,17,22,0,33,15,18,0,15,9,6,0,7,5,2,0,3,1,2,0,4,2,2,0
,,Michigan,170,96,74,0,166,93,73,0,138,79,59,0,67,40,27,0,34,18,16,0,28,13,15,0,17,9,8,0
,,Minnesota,82,51,31,0,82,51,31,0,72,44,28,0,31,17,14,0,35,24,11,0,14,6,8,0,6,4,2,0
,,Mississippi,51,35,16,0,51,35,16,0,43,31,12,0,24,14,10,0,14,11,3,0,6,4,2,0,10,6,4,0
,,Missouri,100,64,36,0,97,62,35,0,88,55,33,0,39,28,11,0,14,9,5,0,17,12,5,0,11,8,3,0
,,Montana,23,16,7,0,23,16,7,0,20,15,5,0,11,5,6,0,3,1,2,0,2,1,1,0,1,1,0,0
,,Nebraska,24,14,10,0,23,14,9,0,20,12,8,0,6,2,4,0,12,8,4,0,2,1,1,0,6,2,4,0
,,Nevada,32,20,12,0,31,19,12,0,27,17,10,0,14,9,5,0,5,5,0,0,0,0,0,0,5,3,2,0
,,New Hampshire,7,4,3,0,7,4,3,0,5,2,3,0,1,1,0,0,1,1,0,0,0,0,0,0,0,0,0,0
,,New Jersey,97,53,44,0,92,49,43,0,71,38,33,0,30,20,10,0,20,12,8,0,8,6,2,0,4,2,2,0
,,New Mexico,32,17,15,0,31,16,15,0,31,16,15,0,13,7,6,0,2,2,0,0,2,1,1,0,2,1,1,0
,,New York,185,110,75,0,177,105,72,0,141,85,56,0,75,48,27,0,28,16,12,0,13,9,4,0,11,7,4,0
,,North Carolina,132,72,60,0,130,70,60,0,119,65,54,0,51,27,24,0,41,27,14,0,20,9,11,0,11,7,4,0
,,North Dakota,14,8,6,0,14,8,6,0,12,8,4,0,6,3,3,0,3,3,0,0,1,1,0,0,5,3,2,0
,,Ohio,157,99,58,0,154,96,58,0,125,78,47,0,53,37,16,0,51,33,18,0,19,8,11,0,9,7,2,0
,,Oklahoma,71,46,25,0,68,44,24,0,55,35,20,0,29,18,11,0,5,2,3,0,4,1,3,0,6,4,2,0
,,Oregon,42,29,13,0,41,29,12,0,36,25,11,0,15,10,5,0,5,5,0,0,2,1,1,0,2,2,0,0
,,Pennsylvania,206,122,84,0,203,120,83,0,170,100,70,0,79,47,32,0,64,43,21,0,27,19,8,0,13,6,7,0
,,Puerto Rico,25,17,8,0,23,16,7,0,21,14,7,0,6,4,2,0,5,3,2,0,0,0,0,0,3,2,1,0
,,Rhode Island,12,8,4,0,11,7,4,0,9,6,3,0,5,3,2,0,2,0,2,0,2,0,2,0,1,1,0,0
,,South Carolina,75,40,35,0,74,39,35,0,66,37,29,0,36,19,17,0,22,11,11,0,8,5,3,0,5,2,3,0
,,South Dakota,20,12,8,0,20,12,8,0,20,12,8,0,10,6,4,0,7,3,4,0,5,2,3,0,4,3,1,0
,,,,,,,,,,,,,,,,,,,,,,,,,,,,,,
,,,,,,,,,,,,,,,,,,,,,,,,,,,,,,
,,State unassigned,77,53,24,0,76,52,24,0,67,45,22,0,30,21,9,0,13,7,6,0,10,6,4,0,4,1,3,0
,,Tennessee,96,66,30,0,95,65,30,0,77,53,24,0,37,24,13,0,25,20,5,0,9,6,3,0,8,6,2,0
,,Texas,399,242,157,0,394,239,155,0,339,201,138,0,153,91,62,0,50,33,17,0,36,21,15,0,19,11,8,0
,,Utah,51,31,20,0,51,31,20,0,48,28,20,0,20,15,5,0,9,7,2,0,0,0,0,0,3,1,2,0
,,Vermont,10,3,7,0,10,3,7,0,10,3,7,0,4,2,2,0,1,1,0,0,1,0,1,0,0,0,0,0
,,Virginia,93,57,36,0,93,57,36,0,77,49,28,0,37,21,16,0,17,14,3,0,12,7,5,0,8,4,4,0
,,Washington,67,42,25,0,63,39,24,0,56,33,23,0,22,16,6,0,7,6,1,0,4,3,1,0,1,0,1,0
,,West Virginia,40,24,16,0,40,24,16,0,35,21,14,0,12,6,6,0,2,0,2,0,5,3,2,0,2,1,1,0
,,Wisconsin,99,61,38,0,96,60,36,0,89,57,32,0,40,27,13,0,44,29,15,0,13,9,4,0,3,2,1,0
,,Wyoming,6,3,3,0,6,3,3,0,3,1,2,0,1,0,1,0,1,0,1,0,0,0,0,0,0,0,0,0
,11-17 Years,All Donor States of Residence,16574,11217,5357,0,16200,10968,5232,0,14492,9872,4620,0,9563,6882,2681,0,7709,5382,2327,0,4568,3158,1410,0,440,285,155,0
,,Alabama,328,225,103,0,321,221,100,0,268,185,83,0,180,133,47,0,131,95,36,0,85,65,20,0,5,5,0,0
,,Alaska,58,46,12,0,57,45,12,0,49,39,10,0,27,25,2,0,31,25,6,0,16,12,4,0,0,0,0,0
,,Arizona,303,204,99,0,298,200,98,0,271,180,91,0,158,110,48,0,120,73,47,0,80,55,25,0,5,4,1,0
,,Arkansas,177,118,59,0,172,115,57,0,153,101,52,0,108,77,31,0,59,41,18,0,50,25,25,0,6,3,3,0
,,California,1498,1065,433,0,1456,1035,421,0,1348,959,389,0,946,706,240,0,692,511,181,0,427,303,124,0,22,12,10,0
,,Colorado,291,194,97,0,284,190,94,0,268,181,87,0,185,128,57,0,156,103,53,0,76,48,28,0,6,4,2,0
,,Connecticut,130,97,33,0,124,92,32,0,104,75,29,0,77,58,19,0,50,36,14,0,21,14,7,0,1,0,1,0
,,Delaware,53,35,18,0,51,34,17,0,46,30,16,0,22,15,7,0,23,12,11,0,11,7,4,0,1,1,0,0
,,District of Columbia,33,26,7,0,32,25,7,0,29,23,6,0,22,19,3,0,24,19,5,0,9,5,4,0,0,0,0,0
,,Florida,955,628,327,0,935,615,320,0,826,547,279,0,513,368,145,0,422,293,129,0,252,170,82,0,63,38,25,0
,,Georgia,498,345,153,0,489,338,151,0,439,309,130,0,310,227,83,0,197,148,49,0,133,97,36,0,12,5,7,0
,,Hawaii,35,27,8,0,34,26,8,0,32,25,7,0,9,8,1,0,13,10,3,0,2,2,0,0,0,0,0,0
,,Idaho,111,72,39,0,108,70,38,0,100,66,34,0,72,50,22,0,55,39,16,0,24,15,9,0,4,1,3,0
,,Illinois,725,509,216,0,710,503,207,0,625,439,186,0,380,288,92,0,386,285,101,0,236,172,64,0,14,8,6,0
,,Indiana,415,286,129,0,407,280,127,0,380,261,119,0,272,197,75,0,234,160,74,0,121,82,39,0,39,25,14,0
,,Iowa,206,121,85,0,199,114,85,0,188,113,75,0,106,67,39,0,113,74,39,0,57,34,23,0,3,0,3,0
,,Kansas,257,170,87,0,255,169,86,0,233,152,81,0,137,100,37,0,133,87,46,0,77,51,26,0,6,6,0,0
,,Kentucky,239,153,86,0,234,149,85,0,214,139,75,0,135,92,43,0,103,67,36,0,84,56,28,0,4,3,1,0
,,Louisiana,384,267,117,0,376,262,114,0,356,247,109,0,246,180,66,0,210,144,66,0,125,96,29,0,16,11,5,0
,,Maine,69,44,25,0,67,42,25,0,61,37,24,0,37,28,9,0,33,19,14,0,7,5,2,0,1,1,0,0
,,Maryland,268,177,91,0,260,172,88,0,234,159,75,0,152,108,44,0,157,109,48,0,94,66,28,0,10,6,4,0
,,Massachusetts,213,144,69,0,208,141,67,0,167,116,51,0,113,81,32,0,81,54,27,0,42,25,17,0,3,1,2,0
,,Michigan,621,414,207,0,605,405,200,0,516,346,170,0,322,222,100,0,264,185,79,0,167,118,49,0,21,16,5,0
,,Minnesota,272,178,94,0,268,175,93,0,244,164,80,0,156,103,53,0,184,123,61,0,87,49,38,0,7,6,1,0
,,Mississippi,223,138,85,0,217,135,82,0,184,118,66,0,134,89,45,0,92,55,37,0,53,39,14,0,13,7,6,0
,,Missouri,441,290,151,0,430,284,146,0,398,263,135,0,264,190,74,0,192,133,59,0,143,101,42,0,13,7,6,0
,,Montana,78,51,27,0,78,51,27,0,71,47,24,0,46,34,12,0,36,24,12,0,19,14,5,0,0,0,0,0
,,Nebraska,132,77,55,0,131,76,55,0,124,74,50,0,68,42,26,0,86,55,31,0,33,22,11,0,6,6,0,0
,,Nevada,140,88,52,0,139,87,52,0,131,82,49,0,91,58,33,0,61,39,22,0,38,22,16,0,5,3,2,0
,,New Hampshire,55,41,14,0,53,40,13,0,43,31,12,0,27,21,6,0,27,19,8,0,12,9,3,0,0,0,0,0
,,,,,,,,,,,,,,,,,,,,,,,,,,,,,,
,,,,,,,,,,,,,,,,,,,,,,,,,,,,,,
,,New Jersey,286,192,94,0,281,191,90,0,245,162,83,0,161,110,51,0,142,100,42,0,70,42,28,0,5,2,3,0
,,New Mexico,136,94,42,0,132,91,41,0,115,80,35,0,78,56,22,0,31,20,11,0,35,25,10,0,3,2,1,0
,,New York,600,389,211,0,580,373,207,0,504,331,173,0,350,240,110,0,252,164,88,0,130,84,46,0,22,15,7,0
,,North Carolina,456,306,150,0,449,300,149,0,393,259,134,0,262,188,74,0,248,170,78,0,128,87,41,0,7,4,3,0
,,North Dakota,46,30,16,0,45,30,15,0,40,26,14,0,24,20,4,0,30,20,10,0,11,5,6,0,1,1,0,0
,,Ohio,634,432,202,0,626,428,198,0,552,388,164,0,364,270,94,0,364,263,101,0,199,140,59,0,21,12,9,0
,,Oklahoma,285,196,89,0,278,190,88,0,253,177,76,0,160,111,49,0,77,58,19,0,64,47,17,0,2,2,0,0
,,Oregon,189,121,68,0,188,120,68,0,169,109,60,0,91,68,23,0,78,59,19,0,38,27,11,0,1,1,0,0
,,Pennsylvania,693,484,209,0,675,471,204,0,613,436,177,0,386,280,106,0,365,263,102,0,210,149,61,0,24,17,7,0
,,Puerto Rico,112,87,25,0,111,86,25,0,89,70,19,0,48,41,7,0,41,28,13,0,27,19,8,0,5,4,1,0
,,Rhode Island,23,19,4,0,21,17,4,0,19,16,3,0,16,13,3,0,13,10,3,0,4,4,0,0,0,0,0,0
,,South Carolina,275,190,85,0,272,188,84,0,247,172,75,0,178,137,41,0,133,98,35,0,86,68,18,0,4,3,1,0
,,South Dakota,51,29,22,0,51,29,22,0,45,26,19,0,27,18,9,0,36,21,15,0,23,15,8,0,2,1,1,0
,,State unassigned,277,198,79,0,268,195,73,0,213,158,55,0,154,114,40,0,79,63,16,0,54,36,18,0,3,1,2,0
,,Tennessee,404,263,141,0,394,256,138,0,348,231,117,0,247,183,64,0,210,143,67,0,124,86,38,0,11,8,3,0
,,Texas,1503,1014,489,0,1461,986,475,0,1309,892,417,0,929,664,265,0,523,376,147,0,440,311,129,0,19,15,4,0
,,Utah,195,124,71,0,189,122,67,0,167,108,59,0,94,55,39,0,78,50,28,0,38,25,13,0,2,2,0,0
,,Vermont,35,24,11,0,35,24,11,0,32,23,9,0,20,14,6,0,13,9,4,0,9,7,2,0,1,0,1,0
,,Virginia,358,261,97,0,349,253,96,0,314,227,87,0,209,156,53,0,153,111,42,0,98,72,26,0,8,5,3,0
,,Washington,277,184,93,0,270,180,90,0,251,165,86,0,149,109,40,0,121,85,36,0,65,41,24,0,2,2,0,0
,,West Virginia,118,78,40,0,117,77,40,0,103,66,37,0,62,46,16,0,61,42,19,0,31,23,8,0,4,4,0,0
,,Wisconsin,366,234,132,0,365,234,131,0,328,210,118,0,204,136,68,0,273,173,100,0,89,55,34,0,7,5,2,0
,,Wyoming,47,38,9,0,45,36,9,0,41,32,9,0,35,29,6,0,23,19,4,0,14,11,3,0,0,0,0,0
,18-34 Years,All Donor States of Residence,118246,70187,48059,0,111623,66419,45204,0,58036,40296,17740,0,35821,27260,8561,0,24124,17825,6299,0,17341,12202,5139,0,830,535,295,0
,,Alabama,2063,1215,848,0,2008,1180,828,0,1015,722,293,0,629,484,145,0,363,281,82,0,298,220,78,0,4,3,1,0
,,Alaska,317,197,120,0,306,189,117,0,189,140,49,0,111,91,20,0,88,73,15,0,66,52,14,0,0,0,0,0
,,Arizona,2351,1404,947,0,2264,1356,908,0,1142,831,311,0,669,519,150,0,410,314,96,0,374,264,110,0,10,9,1,0
,,Arkansas,1085,665,420,0,1034,633,401,0,625,431,194,0,421,314,107,0,246,175,71,0,197,128,69,0,23,16,7,0
,,California,12272,7348,4924,0,11534,6929,4605,0,5998,4282,1716,0,3939,3111,828,0,2349,1774,575,0,1858,1344,514,0,26,15,11,0
,,Colorado,1753,1053,700,0,1627,975,652,0,907,615,292,0,531,404,127,0,354,253,101,0,234,157,77,0,5,4,1,0
,,Connecticut,1108,660,448,0,1038,619,419,0,510,364,146,0,303,240,63,0,181,141,40,0,108,80,28,0,5,4,1,0
,,Delaware,415,250,165,0,393,235,158,0,236,162,74,0,152,114,38,0,116,89,27,0,83,62,21,0,4,3,1,0
,,District of Columbia,382,241,141,0,364,234,130,0,149,115,34,0,104,87,17,0,95,79,16,0,57,45,12,0,4,3,1,0
,,Florida,6005,3805,2200,0,5705,3622,2083,0,3646,2582,1064,0,2183,1650,533,0,1458,1085,373,0,1066,730,336,0,87,54,33,0
,,Georgia,3104,1789,1315,0,2919,1679,1240,0,1604,1098,506,0,1089,814,275,0,568,423,145,0,512,351,161,0,21,12,9,0
,,Hawaii,351,220,131,0,337,215,122,0,166,125,41,0,31,25,6,0,64,54,10,0,14,8,6,0,0,0,0,0
,,Idaho,484,284,200,0,463,273,190,0,248,173,75,0,153,117,36,0,93,73,20,0,65,46,19,0,1,0,1,0
,,Illinois,5857,3403,2454,0,5496,3212,2284,0,2396,1656,740,0,1384,1065,319,0,1253,920,333,0,758,546,212,0,41,32,9,0
,,Indiana,2572,1538,1034,0,2470,1473,997,0,1374,943,431,0,884,667,217,0,582,426,156,0,469,326,143,0,90,59,31,0
,,Iowa,1082,637,445,0,1038,615,423,0,507,340,167,0,295,220,75,0,247,178,69,0,151,106,45,0,7,4,3,0
,,Kansas,1108,687,421,0,1071,663,408,0,666,468,198,0,401,310,91,0,318,229,89,0,215,155,60,0,8,4,4,0
,,,,,,,,,,,,,,,,,,,,,,,,,,,,,,
,,,,,,,,,,,,,,,,,,,,,,,,,,,,,,
,,Kentucky,1551,935,616,0,1484,890,594,0,831,583,248,0,513,393,120,0,387,288,99,0,236,183,53,0,7,5,2,0
,,Louisiana,2074,1271,803,0,1962,1201,761,0,1208,859,349,0,750,592,158,0,529,404,125,0,374,264,110,0,12,11,1,0
,,Maine,478,292,186,0,440,270,170,0,267,182,85,0,157,118,39,0,99,72,27,0,66,48,18,0,3,3,0,0
,,Maryland,2700,1536,1164,0,2529,1433,1096,0,1208,838,370,0,677,521,156,0,629,466,163,0,403,289,114,0,16,12,4,0
,,Massachusetts,2258,1327,931,0,2081,1223,858,0,950,647,303,0,530,395,135,0,296,226,70,0,211,155,56,0,10,6,4,0
,,Michigan,4295,2463,1832,0,4100,2361,1739,0,1813,1248,565,0,1094,814,280,0,682,511,171,0,605,423,182,0,37,21,16,0
,,Minnesota,2485,1394,1091,0,2352,1324,1028,0,886,592,294,0,538,385,153,0,585,406,179,0,268,180,88,0,27,18,9,0
,,Mississippi,929,551,378,0,887,529,358,0,489,336,153,0,304,221,83,0,197,147,50,0,144,100,44,0,8,7,1,0
,,Missouri,2543,1549,994,0,2409,1468,941,0,1453,1017,436,0,907,676,231,0,601,442,159,0,554,387,167,0,27,17,10,0
,,Montana,345,218,127,0,323,202,121,0,190,140,50,0,125,98,27,0,87,68,19,0,43,31,12,0,3,2,1,0
,,Nebraska,648,384,264,0,615,366,249,0,342,234,108,0,215,153,62,0,178,121,57,0,105,67,38,0,8,2,6,0
,,Nevada,872,519,353,0,818,483,335,0,477,318,159,0,299,227,72,0,171,124,47,0,145,101,44,0,3,2,1,0
,,New Hampshire,406,231,175,0,374,209,165,0,189,128,61,0,107,77,30,0,71,45,26,0,46,27,19,0,2,2,0,0
,,New Jersey,3030,1738,1292,0,2851,1645,1206,0,1292,850,442,0,780,564,216,0,560,380,180,0,332,222,110,0,6,3,3,0
,,New Mexico,771,480,291,0,740,464,276,0,432,301,131,0,274,214,60,0,123,93,30,0,101,71,30,0,7,5,2,0
,,New York,6530,3746,2784,0,5925,3432,2493,0,2637,1743,894,0,1424,1078,346,0,880,631,249,0,448,304,144,0,23,14,9,0
,,North Carolina,3207,1938,1269,0,3040,1841,1199,0,1670,1167,503,0,1088,845,243,0,802,585,217,0,571,419,152,0,26,18,8,0
,,North Dakota,310,181,129,0,299,174,125,0,128,86,42,0,74,54,20,0,77,52,25,0,34,20,14,0,2,2,0,0
,,Ohio,4956,2818,2138,0,4702,2687,2015,0,2366,1586,780,0,1364,989,375,0,1183,858,325,0,699,476,223,0,49,30,19,0
,,Oklahoma,1288,818,470,0,1220,773,447,0,773,541,232,0,487,363,124,0,230,172,58,0,221,162,59,0,4,1,3,0
,,Oregon,1111,662,449,0,1069,642,427,0,538,382,156,0,325,248,77,0,218,167,51,0,119,85,34,0,0,0,0,0
,,Pennsylvania,5494,3308,2186,0,5087,3084,2003,0,3087,2109,978,0,1753,1328,425,0,1342,969,373,0,984,679,305,0,62,40,22,0
,,Puerto Rico,874,561,313,0,824,535,289,0,475,353,122,0,238,202,36,0,173,137,36,0,123,99,24,0,16,11,5,0
,,Rhode Island,373,202,171,0,344,186,158,0,118,79,39,0,80,57,23,0,45,31,14,0,25,14,11,0,2,1,1,0
,,South Carolina,1615,964,651,0,1556,934,622,0,931,659,272,0,646,512,134,0,419,321,98,0,316,238,78,0,7,4,3,0
,,South Dakota,310,173,137,0,298,167,131,0,152,99,53,0,91,67,24,0,98,65,33,0,46,30,16,0,3,1,2,0
,,State unassigned,2943,1888,1055,0,2684,1725,959,0,1015,731,284,0,655,525,130,0,363,286,77,0,232,178,54,0,9,4,5,0
,,Tennessee,2642,1551,1091,0,2532,1480,1052,0,1400,979,421,0,959,735,224,0,584,435,149,0,439,312,127,0,32,22,10,0
,,Texas,9071,5324,3747,0,8692,5104,3588,0,4569,3191,1378,0,3264,2471,793,0,1505,1140,365,0,1596,1111,485,0,35,24,11,0
,,Utah,1277,744,533,0,1210,707,503,0,541,363,178,0,316,233,83,0,206,147,59,0,134,88,46,0,1,0,1,0
,,Vermont,240,146,94,0,222,133,89,0,122,84,38,0,67,51,16,0,45,33,12,0,24,17,7,0,1,0,1,0
,,Virginia,2920,1670,1250,0,2739,1569,1170,0,1322,885,437,0,797,585,212,0,497,352,145,0,370,254,116,0,18,6,12,0
,,Washington,1891,1112,779,0,1822,1077,745,0,939,649,290,0,552,412,140,0,385,281,104,0,275,189,86,0,3,2,1,0
,,West Virginia,730,438,292,0,664,398,266,0,454,306,148,0,243,174,69,0,184,141,43,0,122,77,45,0,17,12,5,0
,,Wisconsin,2535,1505,1030,0,2439,1456,983,0,1256,876,380,0,756,574,182,0,846,612,234,0,367,254,113,0,7,4,3,0
,,Wyoming,235,154,81,0,223,145,78,0,138,108,30,0,93,77,16,0,62,50,12,0,38,28,10,0,1,1,0,0
,35-49 Years,All Donor States of Residence,128971,59505,69466,0,121511,55460,66051,0,48171,26308,21863,0,19823,12105,7718,0,10264,5366,4898,0,10568,5278,5290,0,297,128,169,0
,,Alabama,2045,924,1121,0,1969,879,1090,0,726,394,332,0,236,150,86,0,78,43,35,0,128,69,59,0,2,0,2,0
,,Alaska,363,171,192,0,356,167,189,0,134,73,61,0,48,32,16,0,24,18,6,0,37,18,19,0,0,0,0,0
,,Arizona,2292,1060,1232,0,2169,992,1177,0,822,467,355,0,320,198,122,0,125,70,55,0,202,113,89,0,3,1,2,0
,,Arkansas,1010,446,564,0,967,421,546,0,461,232,229,0,168,109,59,0,77,40,37,0,72,29,43,0,5,1,4,0
,,,,,,,,,,,,,,,,,,,,,,,,,,,,,,
,,,,,,,,,,,,,,,,,,,,,,,,,,,,,,
,,California,13181,6248,6933,0,12409,5825,6584,0,5052,2885,2167,0,2183,1359,824,0,893,469,424,0,1257,687,570,0,8,2,6,0
,,Colorado,2082,954,1128,0,1955,895,1060,0,732,388,344,0,326,197,129,0,176,90,86,0,128,60,68,0,6,1,5,0
,,Connecticut,1426,657,769,0,1346,617,729,0,491,281,210,0,228,157,71,0,92,50,42,0,83,55,28,0,1,1,0,0
,,Delaware,506,263,243,0,468,241,227,0,242,147,95,0,103,66,37,0,48,29,19,0,74,43,31,0,6,4,2,0
,,District of Columbia,304,144,160,0,287,133,154,0,113,62,51,0,42,23,19,0,30,13,17,0,26,10,16,0,0,0,0,0
,,Florida,6302,3113,3189,0,5929,2906,3023,0,2905,1623,1282,0,1148,700,448,0,517,256,261,0,645,308,337,0,38,16,22,0
,,Georgia,3521,1509,2012,0,3252,1357,1895,0,1410,715,695,0,539,315,224,0,148,80,68,0,293,130,163,0,6,3,3,0
,,Hawaii,465,259,206,0,448,250,198,0,195,118,77,0,22,17,5,0,30,18,12,0,12,4,8,0,0,0,0,0
,,Idaho,585,253,332,0,556,237,319,0,195,116,79,0,77,49,28,0,40,21,19,0,36,24,12,0,0,0,0,0
,,Illinois,5754,2676,3078,0,5408,2499,2909,0,1918,1037,881,0,755,447,308,0,644,321,323,0,459,221,238,0,14,7,7,0
,,Indiana,2757,1238,1519,0,2617,1158,1459,0,1125,603,522,0,503,314,189,0,283,149,134,0,243,116,127,0,24,7,17,0
,,Iowa,1337,583,754,0,1294,561,733,0,414,219,195,0,176,100,76,0,133,63,70,0,97,34,63,0,2,1,1,0
,,Kansas,1121,575,546,0,1073,544,529,0,511,293,218,0,235,151,84,0,147,82,65,0,127,69,58,0,3,1,2,0
,,Kentucky,1670,777,893,0,1597,726,871,0,665,373,292,0,268,171,97,0,139,67,72,0,146,66,80,0,1,0,1,0
,,Louisiana,1802,853,949,0,1658,778,880,0,906,495,411,0,303,178,125,0,168,94,74,0,202,97,105,0,4,1,3,0
,,Maine,620,292,328,0,575,271,304,0,209,127,82,0,86,59,27,0,50,32,18,0,35,19,16,0,2,1,1,0
,,Maryland,3035,1336,1699,0,2832,1221,1611,0,1067,599,468,0,406,227,179,0,299,168,131,0,286,149,137,0,7,4,3,0
,,Massachusetts,2909,1340,1569,0,2687,1230,1457,0,902,503,399,0,403,242,161,0,180,103,77,0,169,89,80,0,2,1,1,0
,,Michigan,4926,2215,2711,0,4683,2093,2590,0,1611,866,745,0,671,397,274,0,317,162,155,0,448,213,235,0,12,4,8,0
,,Minnesota,3085,1375,1710,0,2938,1298,1640,0,834,442,392,0,342,199,143,0,408,214,194,0,206,110,96,0,15,8,7,0
,,Mississippi,1002,478,524,0,950,451,499,0,423,230,193,0,149,96,53,0,61,32,29,0,69,36,33,0,2,0,2,0
,,Missouri,2372,1103,1269,0,2196,1010,1186,0,1069,559,510,0,410,238,172,0,219,110,109,0,296,145,151,0,5,4,1,0
,,Montana,444,198,246,0,427,192,235,0,147,76,71,0,67,44,23,0,32,16,16,0,24,8,16,0,0,0,0,0
,,Nebraska,765,324,441,0,733,309,424,0,279,129,150,0,92,49,43,0,100,48,52,0,50,20,30,0,0,0,0,0
,,Nevada,933,463,470,0,881,433,448,0,431,228,203,0,191,105,86,0,60,38,22,0,103,46,57,0,0,0,0,0
,,New Hampshire,647,306,341,0,604,280,324,0,209,123,86,0,101,62,39,0,46,29,17,0,51,27,24,0,1,1,0,0
,,New Jersey,3897,1782,2115,0,3721,1691,2030,0,1220,675,545,0,541,319,222,0,276,147,129,0,222,107,115,0,3,1,2,0
,,New Mexico,743,328,415,0,708,308,400,0,278,135,143,0,113,65,48,0,29,11,18,0,34,16,18,0,2,2,0,0
,,New York,7477,3407,4070,0,6803,3069,3734,0,2564,1342,1222,0,977,583,394,0,445,232,213,0,305,144,161,0,17,8,9,0
,,North Carolina,3311,1525,1786,0,3137,1423,1714,0,1296,702,594,0,631,388,243,0,333,176,157,0,346,176,170,0,11,3,8,0
,,North Dakota,366,158,208,0,356,154,202,0,90,48,42,0,45,30,15,0,53,32,21,0,18,8,10,0,3,2,1,0
,,Ohio,5559,2526,3033,0,5278,2365,2913,0,2006,1084,922,0,818,488,330,0,601,307,294,0,468,225,243,0,11,6,5,0
,,Oklahoma,1391,643,748,0,1309,593,716,0,627,324,303,0,267,155,112,0,61,36,25,0,114,65,49,0,1,1,0,0
,,Oregon,1325,576,749,0,1285,549,736,0,442,228,214,0,210,115,95,0,85,36,49,0,76,31,45,0,1,0,1,0
,,Pennsylvania,6462,3097,3365,0,6009,2863,3146,0,2816,1558,1258,0,1120,687,433,0,645,326,319,0,592,311,281,0,25,14,11,0
,,Puerto Rico,719,333,386,0,667,300,367,0,302,167,135,0,50,30,20,0,23,14,9,0,50,29,21,0,1,1,0,0
,,Rhode Island,456,189,267,0,431,175,256,0,124,63,61,0,49,25,24,0,32,17,15,0,16,4,12,0,0,0,0,0
,,South Carolina,1792,859,933,0,1695,798,897,0,865,501,364,0,367,251,116,0,147,86,61,0,197,114,83,0,1,0,1,0
,,South Dakota,383,187,196,0,366,175,191,0,127,74,53,0,49,27,22,0,63,32,31,0,28,14,14,0,1,1,0,0
,,State unassigned,2709,1298,1411,0,2569,1219,1350,0,602,356,246,0,297,202,95,0,141,83,58,0,107,59,48,0,2,1,1,0
,,Tennessee,2623,1206,1417,0,2454,1113,1341,0,1206,640,566,0,544,330,214,0,246,123,123,0,255,124,131,0,14,4,10,0
,,,,,,,,,,,,,,,,,,,,,,,,,,,,,,
,,,,,,,,,,,,,,,,,,,,,,,,,,,,,,
,,Texas,9075,4132,4943,0,8546,3844,4702,0,3537,1910,1627,0,1595,1018,577,0,418,213,205,0,925,453,472,0,10,1,9,0
,,Utah,1170,533,637,0,1124,510,614,0,326,173,153,0,167,96,71,0,69,37,32,0,64,27,37,0,0,0,0,0
,,Vermont,278,100,178,0,259,92,167,0,83,30,53,0,28,11,17,0,22,9,13,0,18,7,11,0,0,0,0,0
,,Virginia,3577,1644,1933,0,3377,1522,1855,0,1166,653,513,0,452,284,168,0,188,103,85,0,257,138,119,0,13,8,5,0
,,Washington,2237,976,1261,0,2179,945,1234,0,744,407,337,0,302,174,128,0,166,83,83,0,157,71,86,0,2,0,2,0
,,West Virginia,786,346,440,0,726,314,412,0,373,194,179,0,119,80,39,0,86,40,46,0,64,33,31,0,7,4,3,0
,,Wisconsin,3172,1431,1741,0,3055,1373,1682,0,1108,603,505,0,456,277,179,0,555,290,265,0,240,103,137,0,3,2,1,0
,,Wyoming,202,96,106,0,193,91,102,0,71,38,33,0,28,19,9,0,16,8,8,0,11,4,7,0,0,0,0,0
,50-64 Years,All Donor States of Residence,89826,41449,48377,0,84059,37975,46084,0,41412,21434,19978,0,5773,3032,2741,0,2471,1112,1359,0,5952,2694,3258,0,60,30,30,0
,,Alabama,1400,663,737,0,1291,595,696,0,727,373,354,0,35,22,13,0,11,4,7,0,44,18,26,0,0,0,0,0
,,Alaska,197,100,97,0,193,97,96,0,75,38,37,0,10,5,5,0,2,2,0,0,10,4,6,0,0,0,0,0
,,Arizona,1505,657,848,0,1437,624,813,0,598,306,292,0,64,39,25,0,13,3,10,0,83,42,41,0,1,1,0,0
,,Arkansas,601,269,332,0,565,248,317,0,329,163,166,0,34,20,14,0,12,9,3,0,40,11,29,0,1,1,0,0
,,California,9249,4446,4803,0,8732,4130,4602,0,4363,2351,2012,0,744,411,333,0,157,68,89,0,783,382,401,0,3,2,1,0
,,Colorado,1269,567,702,0,1211,538,673,0,460,221,239,0,75,37,38,0,44,16,28,0,48,21,27,0,3,1,2,0
,,Connecticut,1105,511,594,0,1051,481,570,0,370,193,177,0,73,32,41,0,19,7,12,0,41,26,15,0,0,0,0,0
,,Delaware,356,160,196,0,332,147,185,0,199,99,100,0,36,17,19,0,13,8,5,0,23,9,14,0,0,0,0,0
,,District of Columbia,236,108,128,0,208,90,118,0,121,57,64,0,5,2,3,0,3,1,2,0,15,3,12,0,0,0,0,0
,,Florida,5107,2358,2749,0,4698,2099,2599,0,2703,1395,1308,0,280,145,135,0,78,34,44,0,354,139,215,0,6,1,5,0
,,Georgia,2424,1082,1342,0,2154,914,1240,0,1308,668,640,0,140,78,62,0,13,7,6,0,185,84,101,0,0,0,0,0
,,Hawaii,375,190,185,0,365,186,179,0,166,94,72,0,4,3,1,0,1,1,0,0,4,1,3,0,0,0,0,0
,,Idaho,359,179,180,0,351,173,178,0,138,72,66,0,21,10,11,0,4,1,3,0,18,11,7,0,0,0,0,0
,,Illinois,4121,1984,2137,0,3809,1791,2018,0,1819,971,848,0,234,121,113,0,275,128,147,0,314,160,154,0,10,10,0,0
,,Indiana,1572,676,896,0,1474,627,847,0,793,381,412,0,124,66,58,0,47,19,28,0,138,56,82,0,0,0,0,0
,,Iowa,902,416,486,0,869,399,470,0,357,193,164,0,65,37,28,0,39,23,16,0,38,13,25,0,0,0,0,0
,,Kansas,769,376,393,0,724,347,377,0,409,227,182,0,56,39,17,0,34,18,16,0,62,30,32,0,1,0,1,0
,,Kentucky,965,449,516,0,923,417,506,0,517,279,238,0,70,34,36,0,34,13,21,0,66,26,40,0,0,0,0,0
,,Louisiana,1218,593,625,0,1074,507,567,0,780,412,368,0,53,28,25,0,17,7,10,0,93,41,52,0,1,0,1,0
,,Maine,461,219,242,0,437,202,235,0,156,89,67,0,30,17,13,0,17,8,9,0,23,11,12,0,0,0,0,0
,,Maryland,2186,984,1202,0,2023,888,1135,0,1010,522,488,0,110,55,55,0,40,13,27,0,184,85,99,0,3,0,3,0
,,Massachusetts,2033,913,1120,0,1923,847,1076,0,686,351,335,0,140,69,71,0,45,24,21,0,93,47,46,0,1,1,0,0
,,Michigan,3514,1602,1912,0,3337,1497,1840,0,1372,709,663,0,224,118,106,0,90,46,44,0,260,106,154,0,2,2,0,0
,,Minnesota,2006,893,1113,0,1935,856,1079,0,687,362,325,0,142,73,69,0,169,81,88,0,102,49,53,0,9,4,5,0
,,Mississippi,658,289,369,0,613,263,350,0,377,185,192,0,41,18,23,0,10,4,6,0,38,14,24,0,0,0,0,0
,,Missouri,1796,845,951,0,1635,754,881,0,1044,527,517,0,106,49,57,0,65,25,40,0,173,83,90,0,1,0,1,0
,,Montana,279,102,177,0,274,100,174,0,102,40,62,0,20,6,14,0,8,4,4,0,14,4,10,0,0,0,0,0
,,Nebraska,589,260,329,0,563,247,316,0,250,120,130,0,28,14,14,0,35,16,19,0,35,17,18,0,0,0,0,0
,,Nevada,741,348,393,0,683,314,369,0,419,212,207,0,58,33,25,0,9,3,6,0,49,18,31,0,0,0,0,0
,,New Hampshire,480,205,275,0,455,195,260,0,162,76,86,0,29,11,18,0,12,5,7,0,28,6,22,0,0,0,0,0
,,New Jersey,2994,1255,1739,0,2834,1158,1676,0,1204,604,600,0,169,79,90,0,83,37,46,0,131,61,70,0,0,0,0,0
,,New Mexico,482,220,262,0,455,204,251,0,205,92,113,0,27,10,17,0,8,1,7,0,15,6,9,0,1,1,0,0
,,,,,,,,,,,,,,,,,,,,,,,,,,,,,,
,,,,,,,,,,,,,,,,,,,,,,,,,,,,,,
,,New York,5651,2611,3040,0,5183,2317,2866,0,2355,1262,1093,0,307,174,133,0,104,42,62,0,189,81,108,0,1,0,1,0
,,North Carolina,2285,1054,1231,0,2147,966,1181,0,1060,511,549,0,237,111,126,0,57,24,33,0,223,98,125,0,1,0,1,0
,,North Dakota,224,93,131,0,214,90,124,0,82,42,40,0,11,7,4,0,16,6,10,0,12,5,7,0,1,0,1,0
,,Ohio,3670,1638,2032,0,3464,1514,1950,0,1682,851,831,0,222,106,116,0,145,63,82,0,251,96,155,0,2,1,1,0
,,Oklahoma,968,467,501,0,917,443,474,0,480,232,248,0,65,39,26,0,12,7,5,0,44,18,26,0,0,0,0,0
,,Oregon,918,402,516,0,895,389,506,0,377,181,196,0,64,32,32,0,23,12,11,0,34,13,21,0,1,0,1,0
,,Pennsylvania,5027,2489,2538,0,4675,2276,2399,0,2706,1453,1253,0,458,257,201,0,231,104,127,0,394,196,198,0,3,3,0,0
,,Puerto Rico,724,356,368,0,631,295,336,0,447,234,213,0,3,2,1,0,1,0,1,0,44,27,17,0,0,0,0,0
,,Rhode Island,310,127,183,0,299,121,178,0,90,43,47,0,24,11,13,0,9,4,5,0,13,7,6,0,0,0,0,0
,,South Carolina,1201,578,623,0,1133,541,592,0,743,374,369,0,101,50,51,0,14,8,6,0,116,50,66,0,0,0,0,0
,,South Dakota,261,111,150,0,256,108,148,0,95,48,47,0,13,4,9,0,21,12,9,0,15,5,10,0,1,0,1,0
,,State unassigned,1409,605,804,0,1347,566,781,0,446,220,226,0,78,37,41,0,39,15,24,0,63,31,32,0,1,1,0,0
,,Tennessee,1667,742,925,0,1533,652,881,0,923,438,485,0,125,55,70,0,44,21,23,0,133,54,79,0,1,1,0,0
,,Texas,5834,2669,3165,0,5357,2373,2984,0,2808,1449,1359,0,304,171,133,0,61,24,37,0,433,203,230,0,0,0,0,0
,,Utah,606,282,324,0,568,267,301,0,217,111,106,0,46,23,23,0,8,4,4,0,21,14,7,0,0,0,0,0
,,Vermont,182,88,94,0,173,83,90,0,59,36,23,0,14,8,6,0,2,1,1,0,10,5,5,0,0,0,0,0
,,Virginia,2353,1082,1271,0,2241,1012,1229,0,961,520,441,0,147,76,71,0,39,17,22,0,161,78,83,0,1,0,1,0
,,Washington,1568,698,870,0,1530,673,857,0,579,307,272,0,106,51,55,0,35,16,19,0,95,36,59,0,1,0,1,0
,,West Virginia,541,233,308,0,505,214,291,0,310,143,167,0,28,11,17,0,35,15,20,0,39,16,23,0,2,0,2,0
,,Wisconsin,2329,1142,1187,0,2221,1081,1140,0,1012,563,449,0,161,102,59,0,159,77,82,0,146,73,73,0,1,0,1,0
,,Wyoming,149,63,86,0,142,59,83,0,74,34,40,0,12,7,5,0,9,4,5,0,12,4,8,0,0,0,0,0
,65 +,All Donor States of Residence,18954,8749,10205,0,14897,6627,8270,0,13647,6512,7135,0,126,49,77,0,106,47,59,0,461,187,274,0,6,2,4,0
,,Alabama,252,134,118,0,214,106,108,0,181,99,82,0,0,0,0,0,0,0,0,0,5,1,4,0,0,0,0,0
,,Alaska,21,10,11,0,18,8,10,0,13,6,7,0,0,0,0,0,1,1,0,0,0,0,0,0,0,0,0,0
,,Arizona,280,118,162,0,246,99,147,0,187,86,101,0,0,0,0,0,1,0,1,0,3,1,2,0,0,0,0,0
,,Arkansas,104,44,60,0,82,35,47,0,87,39,48,0,0,0,0,0,0,0,0,0,5,1,4,0,0,0,0,0
,,California,1669,757,912,0,1476,646,830,0,1055,493,562,0,20,7,13,0,14,5,9,0,67,25,42,0,0,0,0,0
,,Colorado,164,72,92,0,141,59,82,0,102,45,57,0,3,0,3,0,4,0,4,0,5,2,3,0,0,0,0,0
,,Connecticut,187,73,114,0,165,61,104,0,110,45,65,0,6,1,5,0,0,0,0,0,7,4,3,0,0,0,0,0
,,Delaware,125,59,66,0,101,45,56,0,100,47,53,0,1,1,0,0,1,0,1,0,5,3,2,0,0,0,0,0
,,District of Columbia,55,26,29,0,43,19,24,0,41,18,23,0,0,0,0,0,0,0,0,0,4,3,1,0,0,0,0,0
,,Florida,1407,629,778,0,971,426,545,0,1071,497,574,0,3,1,2,0,3,2,1,0,21,8,13,0,1,0,1,0
,,Georgia,520,223,297,0,352,134,218,0,417,178,239,0,0,0,0,0,0,0,0,0,11,2,9,0,0,0,0,0
,,Hawaii,39,11,28,0,39,11,28,0,9,2,7,0,0,0,0,0,0,0,0,0,0,0,0,0,0,0,0,0
,,Idaho,28,14,14,0,25,12,13,0,14,8,6,0,0,0,0,0,0,0,0,0,0,0,0,0,0,0,0,0
,,Illinois,897,446,451,0,654,311,343,0,649,335,314,0,13,7,6,0,14,7,7,0,30,14,16,0,3,2,1,0
,,Indiana,239,113,126,0,205,93,112,0,182,88,94,0,0,0,0,0,1,0,1,0,10,5,5,0,0,0,0,0
,,Iowa,143,81,62,0,128,73,55,0,89,48,41,0,2,1,1,0,2,1,1,0,3,1,2,0,0,0,0,0
,,Kansas,184,88,96,0,126,58,68,0,160,74,86,0,0,0,0,0,1,1,0,0,6,1,5,0,0,0,0,0
,,Kentucky,121,57,64,0,106,50,56,0,86,42,44,0,2,0,2,0,3,2,1,0,2,1,1,0,0,0,0,0
,,Louisiana,184,87,97,0,124,53,71,0,151,72,79,0,0,0,0,0,2,1,1,0,5,2,3,0,0,0,0,0
,,,,,,,,,,,,,,,,,,,,,,,,,,,,,,
,,,,,,,,,,,,,,,,,,,,,,,,,,,,,,
,,Maine,95,50,45,0,86,44,42,0,51,26,25,0,0,0,0,0,1,0,1,0,1,0,1,0,0,0,0,0
,,Maryland,537,249,288,0,466,204,262,0,356,184,172,0,0,0,0,0,1,0,1,0,16,11,5,0,0,0,0,0
,,Massachusetts,409,201,208,0,362,172,190,0,263,135,128,0,1,0,1,0,1,1,0,0,13,7,6,0,0,0,0,0
,,Michigan,549,247,302,0,459,198,261,0,344,154,190,0,3,2,1,0,1,1,0,0,34,8,26,0,0,0,0,0
,,Minnesota,386,163,223,0,325,131,194,0,242,109,133,0,4,1,3,0,7,2,5,0,5,4,1,0,0,0,0,0
,,Mississippi,139,69,70,0,108,51,57,0,106,57,49,0,0,0,0,0,0,0,0,0,0,0,0,0,0,0,0,0
,,Missouri,460,229,231,0,293,138,155,0,393,201,192,0,1,1,0,0,5,4,1,0,15,7,8,0,0,0,0,0
,,Montana,31,11,20,0,26,8,18,0,16,7,9,0,0,0,0,0,1,0,1,0,2,1,1,0,0,0,0,0
,,Nebraska,83,37,46,0,69,29,40,0,64,24,40,0,1,1,0,0,1,1,0,0,2,0,2,0,0,0,0,0
,,Nevada,162,76,86,0,132,58,74,0,132,65,67,0,1,1,0,0,1,1,0,0,8,4,4,0,0,0,0,0
,,New Hampshire,80,41,39,0,72,36,36,0,44,26,18,0,0,0,0,0,0,0,0,0,2,1,1,0,0,0,0,0
,,New Jersey,633,283,350,0,559,245,314,0,423,207,216,0,3,0,3,0,2,0,2,0,7,4,3,0,0,0,0,0
,,New Mexico,91,39,52,0,77,32,45,0,62,28,34,0,0,0,0,0,1,0,1,0,2,0,2,0,0,0,0,0
,,New York,1748,777,971,0,1109,478,631,0,1362,624,738,0,4,1,3,0,6,4,2,0,16,6,10,0,0,0,0,0
,,North Carolina,477,212,265,0,384,161,223,0,330,161,169,0,7,4,3,0,3,1,2,0,24,10,14,0,0,0,0,0
,,North Dakota,44,21,23,0,35,14,21,0,28,15,13,0,0,0,0,0,1,1,0,0,0,0,0,0,0,0,0,0
,,Ohio,627,314,313,0,538,264,274,0,433,218,215,0,10,2,8,0,1,0,1,0,21,5,16,0,0,0,0,0
,,Oklahoma,170,81,89,0,142,64,78,0,124,59,65,0,1,1,0,0,0,0,0,0,4,0,4,0,0,0,0,0
,,Oregon,122,41,81,0,119,39,80,0,67,22,45,0,0,0,0,0,1,0,1,0,2,1,1,0,0,0,0,0
,,Pennsylvania,1611,786,825,0,1327,622,705,0,1289,644,645,0,12,6,6,0,11,5,6,0,32,14,18,0,0,0,0,0
,,Puerto Rico,241,118,123,0,155,69,86,0,202,100,102,0,0,0,0,0,0,0,0,0,2,0,2,0,0,0,0,0
,,Rhode Island,44,25,19,0,38,22,16,0,27,17,10,0,0,0,0,0,0,0,0,0,1,0,1,0,0,0,0,0
,,South Carolina,294,131,163,0,244,101,143,0,244,108,136,0,3,2,1,0,1,0,1,0,10,6,4,0,0,0,0,0
,,South Dakota,55,24,31,0,49,21,28,0,42,18,24,0,1,0,1,0,3,1,2,0,3,1,2,0,1,0,1,0
,,State unassigned,261,109,152,0,227,98,129,0,147,66,81,0,2,1,1,0,1,1,0,0,6,3,3,0,0,0,0,0
,,Tennessee,368,161,207,0,304,133,171,0,298,134,164,0,3,1,2,0,1,0,1,0,2,0,2,0,0,0,0,0
,,Texas,1181,533,648,0,739,319,420,0,880,417,463,0,7,4,3,0,2,1,1,0,16,7,9,0,0,0,0,0
,,Utah,65,39,26,0,55,32,23,0,48,31,17,0,1,0,1,0,0,0,0,0,0,0,0,0,0,0,0,0
,,Vermont,42,21,21,0,38,19,19,0,34,19,15,0,0,0,0,0,0,0,0,0,0,0,0,0,0,0,0,0
,,Virginia,479,213,266,0,417,183,234,0,335,143,192,0,4,2,2,0,1,1,0,0,11,4,7,0,1,0,1,0
,,Washington,220,96,124,0,199,84,115,0,120,55,65,0,0,0,0,0,1,0,1,0,3,1,2,0,0,0,0,0
,,West Virginia,151,68,83,0,122,55,67,0,120,52,68,0,0,0,0,0,1,0,1,0,3,2,1,0,0,0,0,0
,,Wisconsin,457,229,228,0,385,193,192,0,300,152,148,0,6,0,6,0,2,1,1,0,9,6,3,0,0,0,0,0
,,Wyoming,23,13,10,0,21,11,10,0,17,12,5,0,1,1,0,0,1,1,0,0,0,0,0,0,0,0,0,0
,Unknown,All Donor States of Residence,25,13,11,1,11,6,4,1,14,7,7,0,1,1,0,0,0,0,0,0,0,0,0,0,0,0,0,0
,,Alabama,1,0,1,0,0,0,0,0,1,0,1,0,0,0,0,0,0,0,0,0,0,0,0,0,0,0,0,0
,,California,1,0,1,0,0,0,0,0,1,0,1,0,0,0,0,0,0,0,0,0,0,0,0,0,0,0,0,0
,,Maryland,1,1,0,0,0,0,0,0,1,1,0,0,0,0,0,0,0,0,0,0,0,0,0,0,0,0,0,0
,,Missouri,1,1,0,0,0,0,0,0,1,1,0,0,0,0,0,0,0,0,0,0,0,0,0,0,0,0,0,0
,,New York,2,0,2,0,0,0,0,0,2,0,2,0,0,0,0,0,0,0,0,0,0,0,0,0,0,0,0,0
,,North Carolina,1,0,1,0,0,0,0,0,1,0,1,0,0,0,0,0,0,0,0,0,0,0,0,0,0,0,0,0
,,,,,,,,,,,,,,,,,,,,,,,,,,,,,,
,,,,,,,,,,,,,,,,,,,,,,,,,,,,,,
,,State unassigned,12,6,5,1,9,4,4,1,3,2,1,0,1,1,0,0,0,0,0,0,0,0,0,0,0,0,0,0
,,Texas,2,2,0,0,2,2,0,0,0,0,0,0,0,0,0,0,0,0,0,0,0,0,0,0,0,0,0,0
,,Virginia,4,3,1,0,0,0,0,0,4,3,1,0,0,0,0,0,0,0,0,0,0,0,0,0,0,0,0,0
Deceased Donor,All Ages,All Donor States of Residence,222013,132737,89276,0,203365,121685,81680,0,179950,107646,72304,0,78066,53391,24675,0,46502,30885,15617,0,39371,23760,15611,0,3386,1988,1398,0
,,Alabama,3750,2264,1486,0,3452,2079,1373,0,3091,1867,1224,0,1191,853,338,0,602,433,169,0,569,377,192,0,36,22,14,0
,,Alaska,622,395,227,0,604,381,223,0,490,317,173,0,209,165,44,0,150,121,29,0,128,85,43,0,1,1,0,0
,,Arizona,3771,2350,1421,0,3593,2245,1348,0,3106,1953,1153,0,1339,954,385,0,687,474,213,0,729,465,264,0,45,34,11,0
,,Arkansas,2056,1212,844,0,1905,1122,783,0,1741,1023,718,0,811,565,246,0,418,278,140,0,366,193,173,0,56,33,23,0
,,California,22206,13747,8459,0,20749,12847,7902,0,18029,11199,6830,0,8556,6005,2551,0,4221,2908,1313,0,4350,2703,1647,0,156,86,70,0
,,Colorado,2937,1739,1198,0,2753,1628,1125,0,2404,1439,965,0,1210,827,383,0,756,476,280,0,489,287,202,0,41,22,19,0
,,Connecticut,1966,1223,743,0,1846,1146,700,0,1546,949,597,0,725,511,214,0,353,241,112,0,271,185,86,0,21,13,8,0
,,Delaware,1027,614,413,0,940,559,381,0,831,491,340,0,328,222,106,0,203,138,65,0,199,126,73,0,13,10,3,0
,,District of Columbia,560,343,217,0,502,304,198,0,455,284,171,0,185,138,47,0,156,116,40,0,111,67,44,0,8,6,2,0
,,Florida,14567,8660,5907,0,13009,7769,5240,0,11843,7085,4758,0,4587,3128,1459,0,2680,1804,876,0,2389,1387,1002,0,388,233,155,0
,,Georgia,6486,3706,2780,0,5610,3173,2437,0,5469,3152,2317,0,2366,1600,766,0,979,691,288,0,1168,681,487,0,117,65,52,0
,,Hawaii,791,515,276,0,762,499,263,0,576,375,201,0,69,56,13,0,109,84,25,0,32,15,17,0,1,1,0,0
,,Idaho,930,577,353,0,883,546,337,0,753,471,282,0,372,257,115,0,201,138,63,0,148,99,49,0,15,6,9,0
,,Illinois,9630,5875,3755,0,8705,5330,3375,0,7468,4527,2941,0,3052,2090,962,0,2651,1714,937,0,1846,1140,706,0,139,88,51,0
,,Indiana,4736,2810,1926,0,4386,2601,1785,0,4062,2405,1657,0,1950,1341,609,0,1217,796,421,0,1002,595,407,0,201,122,79,0
,,Iowa,1949,1158,791,0,1847,1100,747,0,1623,956,667,0,719,466,253,0,559,354,205,0,348,189,159,0,38,16,22,0
,,Kansas,2568,1580,988,0,2378,1472,906,0,2111,1285,826,0,937,650,287,0,658,431,227,0,496,308,188,0,51,30,21,0
,,Kentucky,2927,1789,1138,0,2734,1656,1078,0,2446,1499,947,0,1091,753,338,0,699,457,242,0,541,336,205,0,47,23,24,0
,,Louisiana,4044,2461,1583,0,3573,2195,1378,0,3613,2207,1406,0,1498,1070,428,0,984,680,304,0,820,513,307,0,75,46,29,0
,,Maine,934,578,356,0,888,551,337,0,718,443,275,0,336,233,103,0,207,132,75,0,126,80,46,0,17,8,9,0
,,Maryland,4570,2684,1886,0,4184,2456,1728,0,3787,2238,1549,0,1436,966,470,0,1161,774,387,0,1004,611,393,0,54,29,25,0
,,Massachusetts,3717,2252,1465,0,3476,2099,1377,0,2761,1654,1107,0,1242,822,420,0,614,416,198,0,502,304,198,0,33,20,13,0
,,Michigan,7804,4563,3241,0,7232,4242,2990,0,5822,3423,2399,0,2548,1689,859,0,1425,947,478,0,1548,886,662,0,153,86,67,0
,,Minnesota,3396,1996,1400,0,3185,1870,1315,0,2866,1679,1187,0,1304,829,475,0,1383,849,534,0,686,403,283,0,86,52,34,0
,,Mississippi,2122,1240,882,0,1955,1134,821,0,1694,1006,688,0,720,479,241,0,395,258,137,0,313,197,116,0,63,36,27,0
,,Missouri,5445,3202,2243,0,4797,2835,1962,0,4569,2684,1885,0,1863,1247,616,0,1127,735,392,0,1214,742,472,0,102,59,43,0
,,Montana,676,396,280,0,643,377,266,0,554,326,228,0,294,201,93,0,171,115,56,0,103,58,45,0,11,8,3,0
,,Nebraska,1283,711,572,0,1200,671,529,0,1099,607,492,0,443,282,161,0,422,254,168,0,225,126,99,0,35,16,19,0
,,Nevada,1992,1138,854,0,1836,1040,796,0,1648,945,703,0,706,461,245,0,310,212,98,0,336,185,151,0,21,14,7,0
,,New Hampshire,793,460,333,0,745,435,310,0,605,356,249,0,270,173,97,0,157,99,58,0,135,67,68,0,3,3,0,0
,,New Jersey,5640,3249,2391,0,5231,3003,2228,0,4392,2525,1867,0,1803,1155,648,0,1096,684,412,0,780,447,333,0,43,23,20,0
,,New Mexico,1459,862,597,0,1363,805,558,0,1152,674,478,0,543,380,163,0,201,129,72,0,194,121,73,0,18,13,5,0
,,New York,11042,6390,4652,0,9458,5518,3940,0,8959,5134,3825,0,3344,2240,1104,0,1761,1120,641,0,1111,634,477,0,140,84,56,0
,,North Carolina,6264,3735,2529,0,5749,3411,2338,0,4985,2953,2032,0,2437,1661,776,0,1520,1006,514,0,1319,805,514,0,127,73,54,0
,,North Dakota,464,274,190,0,440,263,177,0,380,220,160,0,171,119,52,0,181,115,66,0,76,39,37,0,13,7,6,0
,,Ohio,8889,5239,3650,0,8211,4825,3386,0,7199,4272,2927,0,2999,1992,1007,0,2374,1543,831,0,1666,953,713,0,137,83,54,0
,,Oklahoma,3061,1824,1237,0,2836,1685,1151,0,2400,1414,986,0,1094,729,365,0,392,276,116,0,451,291,160,0,31,15,16,0
,,,,,,,,,,,,,,,,,,,,,,,,,,,,,,
,,,,,,,,,,,,,,,,,,,,,,,,,,,,,,
,,Oregon,2031,1196,835,0,1953,1150,803,0,1667,975,692,0,761,501,260,0,414,282,132,0,264,153,111,0,10,7,3,0
,,Pennsylvania,12791,7678,5113,0,11770,7031,4739,0,10447,6257,4190,0,4008,2724,1284,0,2689,1727,962,0,2259,1373,886,0,177,105,72,0
,,Puerto Rico,1879,1147,732,0,1635,996,639,0,1526,939,587,0,355,287,68,0,244,184,60,0,245,173,72,0,29,20,9,0
,,Rhode Island,502,296,206,0,468,275,193,0,356,210,146,0,178,112,66,0,102,63,39,0,58,27,31,0,4,3,1,0
,,South Carolina,3659,2200,1459,0,3404,2052,1352,0,3172,1902,1270,0,1413,1016,397,0,760,542,218,0,732,479,253,0,51,33,18,0
,,South Dakota,557,328,229,0,530,311,219,0,487,287,200,0,202,130,72,0,232,138,94,0,124,70,54,0,16,10,6,0
,,State unassigned,3170,1989,1181,0,2945,1853,1092,0,2310,1482,828,0,1273,933,340,0,636,456,180,0,449,296,153,0,25,10,15,0
,,Tennessee,5244,3069,2175,0,4765,2784,1981,0,4417,2567,1850,0,2090,1427,663,0,1155,766,389,0,970,586,384,0,129,70,59,0
,,Texas,17342,10402,6940,0,15560,9368,6192,0,13995,8413,5582,0,6829,4760,2069,0,2615,1826,789,0,3458,2122,1336,0,207,130,77,0
,,Utah,1727,1029,698,0,1613,967,646,0,1363,833,530,0,702,458,244,0,375,249,126,0,254,153,101,0,13,8,5,0
,,Vermont,398,230,168,0,381,218,163,0,316,185,131,0,138,89,49,0,85,55,30,0,61,35,26,0,3,1,2,0
,,Virginia,4974,2950,2024,0,4664,2766,1898,0,4058,2416,1642,0,1761,1192,569,0,915,610,305,0,912,551,361,0,75,38,37,0
,,Washington,3480,2078,1402,0,3325,1992,1333,0,2738,1641,1097,0,1214,805,409,0,723,474,249,0,595,340,255,0,26,13,13,0
,,West Virginia,1603,909,694,0,1483,840,643,0,1367,766,601,0,495,329,166,0,375,242,133,0,269,157,112,0,42,27,15,0
,,Wisconsin,5163,3157,2006,0,4813,2959,1854,0,4138,2512,1626,0,1715,1179,536,0,1890,1191,699,0,857,499,358,0,42,26,16,0
,,Wyoming,419,268,151,0,396,251,145,0,346,224,122,0,184,140,44,0,112,82,30,0,73,46,27,0,1,1,0,0
,< 1 Year,All Donor States of Residence,3384,1916,1468,0,1855,1084,771,0,2339,1314,1025,0,2336,1318,1018,0,426,242,184,0,156,97,59,0,682,375,307,0
,,Alabama,60,35,25,0,32,20,12,0,34,22,12,0,40,23,17,0,6,3,3,0,1,1,0,0,7,4,3,0
,,Alaska,8,2,6,0,7,2,5,0,6,2,4,0,3,2,1,0,1,1,0,0,0,0,0,0,1,1,0,0
,,Arizona,52,31,21,0,39,22,17,0,32,19,13,0,33,19,14,0,3,3,0,0,4,2,2,0,4,3,1,0
,,Arkansas,42,26,16,0,20,14,6,0,31,20,11,0,32,19,13,0,10,5,5,0,0,0,0,0,12,8,4,0
,,California,334,182,152,0,202,113,89,0,216,117,99,0,241,122,119,0,19,9,10,0,12,8,4,0,34,18,16,0
,,Colorado,51,29,22,0,23,12,11,0,31,19,12,0,37,22,15,0,6,3,3,0,0,0,0,0,10,5,5,0
,,Connecticut,23,17,6,0,18,13,5,0,18,14,4,0,16,12,4,0,2,2,0,0,1,0,1,0,3,3,0,0
,,Delaware,8,4,4,0,5,2,3,0,7,4,3,0,5,3,2,0,0,0,0,0,0,0,0,0,1,1,0,0
,,District of Columbia,8,5,3,0,6,4,2,0,8,5,3,0,6,3,3,0,1,1,0,0,1,1,0,0,1,1,0,0
,,Florida,224,128,96,0,98,59,39,0,170,97,73,0,149,79,70,0,54,35,19,0,12,4,8,0,67,40,27,0
,,Georgia,110,63,47,0,48,27,21,0,77,45,32,0,92,53,39,0,18,12,6,0,4,3,1,0,31,18,13,0
,,Hawaii,7,6,1,0,4,4,0,0,4,3,1,0,3,3,0,0,1,1,0,0,0,0,0,0,1,1,0,0
,,Idaho,20,9,11,0,12,4,8,0,13,4,9,0,13,5,8,0,3,0,3,0,1,1,0,0,5,0,5,0
,,Illinois,170,100,70,0,91,59,32,0,116,70,46,0,104,58,46,0,14,11,3,0,10,7,3,0,29,16,13,0
,,Indiana,75,46,29,0,41,26,15,0,54,32,22,0,58,37,21,0,17,12,5,0,4,3,1,0,20,12,8,0
,,Iowa,30,19,11,0,17,11,6,0,23,13,10,0,22,13,9,0,6,2,4,0,1,1,0,0,10,4,6,0
,,Kansas,53,26,27,0,31,17,14,0,34,15,19,0,35,14,21,0,7,5,2,0,1,1,0,0,15,6,9,0
,,Kentucky,50,28,22,0,27,18,9,0,45,27,18,0,40,23,17,0,8,3,5,0,0,0,0,0,14,6,8,0
,,Louisiana,54,28,26,0,23,17,6,0,45,21,24,0,40,24,16,0,12,4,8,0,3,2,1,0,17,7,10,0
,,Maine,8,2,6,0,6,2,4,0,7,1,6,0,5,1,4,0,7,1,6,0,1,0,1,0,7,1,6,0
,,Maryland,54,31,23,0,40,25,15,0,40,20,20,0,33,20,13,0,10,5,5,0,3,2,1,0,11,5,6,0
,,Massachusetts,32,23,9,0,17,12,5,0,21,14,7,0,20,14,6,0,2,1,1,0,2,1,1,0,9,5,4,0
,,Michigan,109,58,51,0,59,32,27,0,72,35,37,0,79,43,36,0,16,11,5,0,4,3,1,0,29,16,13,0
,,Minnesota,59,34,25,0,26,16,10,0,41,25,16,0,42,26,16,0,7,3,4,0,4,2,2,0,10,4,6,0
,,,,,,,,,,,,,,,,,,,,,,,,,,,,,,
,,,,,,,,,,,,,,,,,,,,,,,,,,,,,,
,,Mississippi,43,23,20,0,22,8,14,0,32,15,17,0,26,17,9,0,10,6,4,0,3,3,0,0,13,9,4,0
,,Missouri,80,40,40,0,39,17,22,0,51,25,26,0,53,25,28,0,12,5,7,0,6,4,2,0,20,11,9,0
,,Montana,14,11,3,0,7,4,3,0,11,8,3,0,12,11,1,0,2,1,1,0,0,0,0,0,4,3,1,0
,,Nebraska,24,11,13,0,8,5,3,0,19,8,11,0,13,7,6,0,4,2,2,0,2,2,0,0,7,2,5,0
,,Nevada,35,17,18,0,31,15,16,0,21,11,10,0,24,12,12,0,2,1,1,0,0,0,0,0,4,3,1,0
,,New Hampshire,5,1,4,0,3,1,2,0,5,1,4,0,2,0,2,0,0,0,0,0,1,1,0,0,0,0,0,0
,,New Jersey,69,33,36,0,44,16,28,0,43,23,20,0,47,23,24,0,6,2,4,0,5,4,1,0,11,7,4,0
,,New Mexico,26,17,9,0,13,10,3,0,21,12,9,0,19,12,7,0,3,1,2,0,1,0,1,0,3,2,1,0
,,New York,137,80,57,0,71,41,30,0,95,54,41,0,96,50,46,0,19,13,6,0,7,5,2,0,34,21,13,0
,,North Carolina,125,77,48,0,61,39,22,0,94,59,35,0,87,53,34,0,14,9,5,0,7,4,3,0,33,20,13,0
,,North Dakota,5,2,3,0,3,2,1,0,3,2,1,0,5,2,3,0,0,0,0,0,0,0,0,0,0,0,0,0
,,Ohio,110,60,50,0,58,36,22,0,76,43,33,0,78,44,34,0,14,7,7,0,8,5,3,0,21,12,9,0
,,Oklahoma,42,24,18,0,28,15,13,0,28,15,13,0,29,15,14,0,3,1,2,0,1,0,1,0,7,2,5,0
,,Oregon,31,17,14,0,16,10,6,0,18,9,9,0,22,11,11,0,2,1,1,0,1,1,0,0,3,2,1,0
,,Pennsylvania,155,96,59,0,92,56,36,0,100,60,40,0,93,58,35,0,15,7,8,0,11,6,5,0,25,12,13,0
,,Puerto Rico,9,6,3,0,7,5,2,0,7,4,3,0,6,5,1,0,0,0,0,0,0,0,0,0,0,0,0,0
,,Rhode Island,1,1,0,0,0,0,0,0,0,0,0,0,1,1,0,0,0,0,0,0,0,0,0,0,0,0,0,0
,,South Carolina,34,16,18,0,20,12,8,0,28,12,16,0,28,14,14,0,11,7,4,0,1,1,0,0,16,9,7,0
,,South Dakota,5,2,3,0,2,1,1,0,1,1,0,0,4,2,2,0,0,0,0,0,0,0,0,0,0,0,0,0
,,State unassigned,42,19,23,0,17,10,7,0,27,16,11,0,26,11,15,0,1,1,0,0,0,0,0,0,3,1,2,0
,,Tennessee,102,54,48,0,57,31,26,0,75,36,39,0,80,42,38,0,16,5,11,0,6,1,5,0,26,9,17,0
,,Texas,343,207,136,0,187,114,73,0,242,146,96,0,228,148,80,0,29,21,8,0,15,10,5,0,57,39,18,0
,,Utah,56,34,22,0,45,28,17,0,29,17,12,0,35,23,12,0,3,2,1,0,1,1,0,0,5,3,2,0
,,Vermont,4,3,1,0,2,1,1,0,4,3,1,0,1,1,0,0,1,1,0,0,0,0,0,0,0,0,0,0
,,Virginia,81,42,39,0,48,28,20,0,56,28,28,0,59,30,29,0,10,6,4,0,6,3,3,0,15,9,6,0
,,Washington,63,27,36,0,36,19,17,0,37,17,20,0,40,18,22,0,5,2,3,0,1,1,0,0,8,3,5,0
,,West Virginia,17,8,9,0,11,5,6,0,16,7,9,0,13,5,8,0,6,3,3,0,3,3,0,0,7,3,4,0
,,Wisconsin,75,51,24,0,31,21,10,0,51,36,15,0,53,36,17,0,8,5,3,0,1,0,1,0,12,8,4,0
,,Wyoming,10,5,5,0,4,3,1,0,4,2,2,0,8,4,4,0,0,0,0,0,0,0,0,0,0,0,0,0
,1-5 Years,All Donor States of Residence,6692,3902,2790,0,6183,3598,2585,0,5362,3115,2247,0,2955,1709,1246,0,541,331,210,0,301,165,136,0,789,458,331,0
,,Alabama,106,57,49,0,98,51,47,0,88,49,39,0,45,27,18,0,6,3,3,0,4,1,3,0,12,6,6,0
,,Alaska,27,17,10,0,25,16,9,0,20,13,7,0,7,6,1,0,1,1,0,0,0,0,0,0,0,0,0,0
,,Arizona,141,96,45,0,133,89,44,0,117,79,38,0,71,52,19,0,5,4,1,0,3,1,2,0,14,9,5,0
,,Arkansas,59,39,20,0,56,36,20,0,45,30,15,0,27,14,13,0,6,4,2,0,3,0,3,0,6,4,2,0
,,California,639,378,261,0,575,347,228,0,520,302,218,0,317,182,135,0,21,13,8,0,24,9,15,0,45,25,20,0
,,Colorado,75,48,27,0,64,40,24,0,57,33,24,0,32,23,9,0,3,1,2,0,2,2,0,0,9,7,2,0
,,Connecticut,43,23,20,0,41,22,19,0,32,14,18,0,15,7,8,0,3,3,0,0,4,3,1,0,7,4,3,0
,,Delaware,19,11,8,0,19,11,8,0,15,9,6,0,7,5,2,0,0,0,0,0,1,1,0,0,1,1,0,0
,,District of Columbia,7,5,2,0,7,5,2,0,5,4,1,0,3,2,1,0,1,1,0,0,0,0,0,0,0,0,0,0
,,Florida,487,303,184,0,452,281,171,0,411,253,158,0,195,115,80,0,89,57,32,0,16,10,6,0,86,59,27,0
,,Georgia,224,120,104,0,212,111,101,0,183,95,88,0,116,63,53,0,19,9,10,0,11,2,9,0,31,18,13,0
,,,,,,,,,,,,,,,,,,,,,,,,,,,,,,
,,,,,,,,,,,,,,,,,,,,,,,,,,,,,,
,,Hawaii,15,8,7,0,14,7,7,0,10,6,4,0,0,0,0,0,0,0,0,0,0,0,0,0,0,0,0,0
,,Idaho,59,37,22,0,57,36,21,0,46,29,17,0,26,17,9,0,0,0,0,0,3,2,1,0,1,1,0,0
,,Illinois,290,172,118,0,261,151,110,0,232,134,98,0,119,68,51,0,17,12,5,0,20,14,6,0,39,20,19,0
,,Indiana,159,92,67,0,151,89,62,0,133,77,56,0,68,40,28,0,27,16,11,0,12,6,6,0,24,14,10,0
,,Iowa,77,44,33,0,73,42,31,0,63,37,26,0,37,17,20,0,7,4,3,0,1,1,0,0,16,6,10,0
,,Kansas,97,48,49,0,85,41,44,0,76,40,36,0,45,20,25,0,8,3,5,0,4,1,3,0,15,10,5,0
,,Kentucky,96,59,37,0,88,54,34,0,76,46,30,0,41,25,16,0,13,9,4,0,2,1,1,0,17,8,9,0
,,Louisiana,136,85,51,0,124,78,46,0,119,73,46,0,66,41,25,0,20,12,8,0,7,3,4,0,20,11,9,0
,,Maine,19,8,11,0,18,8,10,0,17,8,9,0,13,6,7,0,1,0,1,0,0,0,0,0,2,1,1,0
,,Maryland,97,47,50,0,93,44,49,0,69,32,37,0,36,21,15,0,6,2,4,0,11,5,6,0,5,1,4,0
,,Massachusetts,54,30,24,0,51,29,22,0,41,23,18,0,20,12,8,0,3,2,1,0,3,0,3,0,5,4,1,0
,,Michigan,209,114,95,0,189,103,86,0,170,88,82,0,89,53,36,0,21,13,8,0,9,5,4,0,36,19,17,0
,,Minnesota,99,55,44,0,91,51,40,0,85,47,38,0,52,25,27,0,8,4,4,0,11,10,1,0,16,10,6,0
,,Mississippi,91,50,41,0,85,46,39,0,72,42,30,0,43,24,19,0,11,3,8,0,3,2,1,0,17,7,10,0
,,Missouri,157,78,79,0,137,66,71,0,134,66,68,0,83,40,43,0,19,7,12,0,14,6,8,0,25,12,13,0
,,Montana,22,7,15,0,20,6,14,0,20,7,13,0,14,4,10,0,2,1,1,0,0,0,0,0,3,2,1,0
,,Nebraska,47,27,20,0,41,24,17,0,41,25,16,0,20,14,6,0,6,3,3,0,2,2,0,0,8,4,4,0
,,Nevada,57,33,24,0,54,31,23,0,49,31,18,0,28,16,12,0,1,1,0,0,1,1,0,0,4,3,1,0
,,New Hampshire,7,4,3,0,7,4,3,0,7,4,3,0,3,1,2,0,0,0,0,0,0,0,0,0,0,0,0,0
,,New Jersey,166,88,78,0,153,80,73,0,118,66,52,0,72,40,32,0,7,6,1,0,9,4,5,0,14,8,6,0
,,New Mexico,47,27,20,0,43,25,18,0,40,24,16,0,19,16,3,0,4,1,3,0,4,2,2,0,1,1,0,0
,,New York,274,163,111,0,251,154,97,0,203,125,78,0,111,66,45,0,29,18,11,0,19,11,8,0,32,19,13,0
,,North Carolina,193,115,78,0,178,108,70,0,158,90,68,0,75,46,29,0,22,14,8,0,9,7,2,0,38,21,17,0
,,North Dakota,20,4,16,0,19,4,15,0,16,2,14,0,6,3,3,0,2,1,1,0,0,0,0,0,2,0,2,0
,,Ohio,232,144,88,0,213,132,81,0,182,113,69,0,90,56,34,0,18,13,5,0,10,3,7,0,24,15,9,0
,,Oklahoma,118,65,53,0,113,61,52,0,90,47,43,0,56,27,29,0,4,0,4,0,2,0,2,0,11,5,6,0
,,Oregon,75,44,31,0,68,39,29,0,62,39,23,0,38,20,18,0,2,2,0,0,0,0,0,0,2,2,0,0
,,Pennsylvania,283,180,103,0,274,173,101,0,219,136,83,0,107,61,46,0,20,12,8,0,21,9,12,0,26,13,13,0
,,Puerto Rico,33,22,11,0,33,22,11,0,24,17,7,0,4,3,1,0,2,2,0,0,0,0,0,0,4,2,2,0
,,Rhode Island,10,6,4,0,10,6,4,0,6,5,1,0,3,2,1,0,1,1,0,0,1,1,0,0,1,1,0,0
,,South Carolina,97,61,36,0,92,58,34,0,86,55,31,0,54,31,23,0,13,11,2,0,2,1,1,0,18,15,3,0
,,South Dakota,26,20,6,0,24,18,6,0,23,19,4,0,7,6,1,0,5,5,0,0,4,3,1,0,4,4,0,0
,,State unassigned,97,57,40,0,83,46,37,0,76,45,31,0,35,25,10,0,3,1,2,0,5,3,2,0,4,2,2,0
,,Tennessee,179,108,71,0,166,101,65,0,153,89,64,0,95,57,38,0,30,19,11,0,6,5,1,0,37,20,17,0
,,Texas,729,415,314,0,686,387,299,0,573,329,244,0,351,194,157,0,28,18,10,0,22,19,3,0,69,40,29,0
,,Utah,76,44,32,0,71,40,31,0,50,30,20,0,24,14,10,0,2,2,0,0,1,1,0,0,2,2,0,0
,,Vermont,7,4,3,0,7,4,3,0,6,4,2,0,4,2,2,0,1,1,0,0,0,0,0,0,1,1,0,0
,,Virginia,142,86,56,0,134,82,52,0,108,66,42,0,57,38,19,0,11,6,5,0,7,4,3,0,14,7,7,0
,,Washington,102,57,45,0,94,52,42,0,79,42,37,0,46,25,21,0,3,1,2,0,2,1,1,0,9,6,3,0
,,West Virginia,46,23,23,0,43,22,21,0,34,16,18,0,18,7,11,0,2,2,0,0,4,1,3,0,3,3,0,0
,,Wisconsin,111,69,42,0,94,61,33,0,91,56,35,0,39,27,12,0,8,7,1,0,2,2,0,0,9,5,4,0
,,,,,,,,,,,,,,,,,,,,,,,,,,,,,,
,,,,,,,,,,,,,,,,,,,,,,,,,,,,,,
,,Wyoming,14,5,9,0,13,4,9,0,12,4,8,0,6,3,3,0,0,0,0,0,0,0,0,0,0,0,0,0
,6-10 Years,All Donor States of Residence,4407,2683,1724,0,4304,2623,1681,0,3682,2248,1434,0,1709,1054,655,0,933,606,327,0,502,280,222,0,326,198,128,0
,,Alabama,83,44,39,0,81,44,37,0,71,36,35,0,28,15,13,0,8,4,4,0,7,4,3,0,6,4,2,0
,,Alaska,17,13,4,0,17,13,4,0,13,10,3,0,4,4,0,0,2,0,2,0,0,0,0,0,0,0,0,0
,,Arizona,83,57,26,0,80,56,24,0,73,50,23,0,26,18,8,0,10,7,3,0,5,5,0,0,8,7,1,0
,,Arkansas,43,22,21,0,42,22,20,0,35,19,16,0,21,12,9,0,9,4,5,0,5,2,3,0,3,0,3,0
,,California,404,257,147,0,390,250,140,0,351,227,124,0,175,111,64,0,77,59,18,0,51,29,22,0,20,13,7,0
,,Colorado,51,33,18,0,49,33,16,0,39,29,10,0,21,16,5,0,13,10,3,0,1,1,0,0,3,1,2,0
,,Connecticut,38,23,15,0,37,23,14,0,29,17,12,0,7,4,3,0,7,3,4,0,8,5,3,0,4,1,3,0
,,Delaware,17,8,9,0,17,8,9,0,12,5,7,0,2,1,1,0,3,1,2,0,2,1,1,0,0,0,0,0
,,District of Columbia,9,7,2,0,8,6,2,0,9,7,2,0,3,2,1,0,2,2,0,0,0,0,0,0,3,2,1,0
,,Florida,286,178,108,0,275,173,102,0,242,154,88,0,117,71,46,0,61,43,18,0,42,23,19,0,40,25,15,0
,,Georgia,156,99,57,0,155,99,56,0,124,78,46,0,81,51,30,0,18,13,5,0,23,14,9,0,16,9,7,0
,,Hawaii,16,11,5,0,15,10,5,0,12,9,3,0,0,0,0,0,0,0,0,0,0,0,0,0,0,0,0,0
,,Idaho,30,21,9,0,29,20,9,0,25,16,9,0,12,9,3,0,6,4,2,0,1,0,1,0,4,4,0,0
,,Illinois,177,111,66,0,174,108,66,0,151,91,60,0,63,36,27,0,56,33,23,0,25,10,15,0,9,5,4,0
,,Indiana,106,59,47,0,102,57,45,0,87,51,36,0,41,20,21,0,27,14,13,0,13,5,8,0,7,6,1,0
,,Iowa,48,25,23,0,48,25,23,0,33,18,15,0,16,11,5,0,14,10,4,0,5,2,3,0,1,1,0,0
,,Kansas,67,41,26,0,66,41,25,0,52,34,18,0,28,16,12,0,11,6,5,0,9,5,4,0,3,3,0,0
,,Kentucky,64,37,27,0,62,36,26,0,52,31,21,0,22,15,7,0,14,9,5,0,6,3,3,0,4,1,3,0
,,Louisiana,98,58,40,0,95,56,39,0,87,50,37,0,40,27,13,0,26,14,12,0,13,9,4,0,7,6,1,0
,,Maine,20,12,8,0,20,12,8,0,15,9,6,0,8,4,4,0,0,0,0,0,3,2,1,0,2,1,1,0
,,Maryland,62,36,26,0,61,36,25,0,49,28,21,0,22,14,8,0,20,11,9,0,10,5,5,0,2,1,1,0
,,Massachusetts,39,17,22,0,39,17,22,0,33,15,18,0,15,9,6,0,7,5,2,0,3,1,2,0,4,2,2,0
,,Michigan,170,96,74,0,166,93,73,0,138,79,59,0,67,40,27,0,34,18,16,0,28,13,15,0,17,9,8,0
,,Minnesota,82,51,31,0,82,51,31,0,72,44,28,0,31,17,14,0,35,24,11,0,14,6,8,0,6,4,2,0
,,Mississippi,51,35,16,0,51,35,16,0,43,31,12,0,24,14,10,0,14,11,3,0,6,4,2,0,10,6,4,0
,,Missouri,99,63,36,0,97,62,35,0,87,54,33,0,39,28,11,0,14,9,5,0,17,12,5,0,11,8,3,0
,,Montana,23,16,7,0,23,16,7,0,20,15,5,0,11,5,6,0,3,1,2,0,2,1,1,0,1,1,0,0
,,Nebraska,24,14,10,0,23,14,9,0,20,12,8,0,6,2,4,0,12,8,4,0,2,1,1,0,6,2,4,0
,,Nevada,32,20,12,0,31,19,12,0,27,17,10,0,14,9,5,0,5,5,0,0,0,0,0,0,5,3,2,0
,,New Hampshire,7,4,3,0,7,4,3,0,5,2,3,0,1,1,0,0,1,1,0,0,0,0,0,0,0,0,0,0
,,New Jersey,97,53,44,0,92,49,43,0,71,38,33,0,30,20,10,0,20,12,8,0,8,6,2,0,4,2,2,0
,,New Mexico,32,17,15,0,31,16,15,0,31,16,15,0,13,7,6,0,2,2,0,0,2,1,1,0,2,1,1,0
,,New York,184,110,74,0,177,105,72,0,140,85,55,0,75,48,27,0,28,16,12,0,13,9,4,0,11,7,4,0
,,North Carolina,132,72,60,0,130,70,60,0,119,65,54,0,51,27,24,0,41,27,14,0,20,9,11,0,11,7,4,0
,,North Dakota,14,8,6,0,14,8,6,0,12,8,4,0,6,3,3,0,3,3,0,0,1,1,0,0,5,3,2,0
,,Ohio,157,99,58,0,154,96,58,0,125,78,47,0,53,37,16,0,51,33,18,0,19,8,11,0,9,7,2,0
,,Oklahoma,71,46,25,0,68,44,24,0,55,35,20,0,29,18,11,0,5,2,3,0,4,1,3,0,6,4,2,0
,,Oregon,42,29,13,0,41,29,12,0,36,25,11,0,15,10,5,0,5,5,0,0,2,1,1,0,2,2,0,0
,,Pennsylvania,206,122,84,0,203,120,83,0,170,100,70,0,79,47,32,0,64,43,21,0,27,19,8,0,13,6,7,0
,,,,,,,,,,,,,,,,,,,,,,,,,,,,,,
,,,,,,,,,,,,,,,,,,,,,,,,,,,,,,
,,Puerto Rico,25,17,8,0,23,16,7,0,21,14,7,0,6,4,2,0,5,3,2,0,0,0,0,0,3,2,1,0
,,Rhode Island,12,8,4,0,11,7,4,0,9,6,3,0,5,3,2,0,2,0,2,0,2,0,2,0,1,1,0,0
,,South Carolina,75,40,35,0,74,39,35,0,66,37,29,0,36,19,17,0,22,11,11,0,8,5,3,0,5,2,3,0
,,South Dakota,20,12,8,0,20,12,8,0,20,12,8,0,10,6,4,0,7,3,4,0,5,2,3,0,4,3,1,0
,,State unassigned,77,53,24,0,76,52,24,0,67,45,22,0,30,21,9,0,13,7,6,0,10,6,4,0,4,1,3,0
,,Tennessee,96,66,30,0,95,65,30,0,77,53,24,0,37,24,13,0,25,20,5,0,9,6,3,0,8,6,2,0
,,Texas,399,242,157,0,394,239,155,0,339,201,138,0,153,91,62,0,50,33,17,0,36,21,15,0,19,11,8,0
,,Utah,51,31,20,0,51,31,20,0,48,28,20,0,20,15,5,0,9,7,2,0,0,0,0,0,3,1,2,0
,,Vermont,10,3,7,0,10,3,7,0,10,3,7,0,4,2,2,0,1,1,0,0,1,0,1,0,0,0,0,0
,,Virginia,93,57,36,0,93,57,36,0,77,49,28,0,37,21,16,0,17,14,3,0,12,7,5,0,8,4,4,0
,,Washington,67,42,25,0,63,39,24,0,56,33,23,0,22,16,6,0,7,6,1,0,4,3,1,0,1,0,1,0
,,West Virginia,40,24,16,0,40,24,16,0,35,21,14,0,12,6,6,0,2,0,2,0,5,3,2,0,2,1,1,0
,,Wisconsin,99,61,38,0,96,60,36,0,89,57,32,0,40,27,13,0,44,29,15,0,13,9,4,0,3,2,1,0
,,Wyoming,6,3,3,0,6,3,3,0,3,1,2,0,1,0,1,0,1,0,1,0,0,0,0,0,0,0,0,0
,11-17 Years,All Donor States of Residence,16509,11189,5320,0,16155,10948,5207,0,14472,9864,4608,0,9563,6882,2681,0,7709,5382,2327,0,4568,3158,1410,0,440,285,155,0
,,Alabama,328,225,103,0,321,221,100,0,268,185,83,0,180,133,47,0,131,95,36,0,85,65,20,0,5,5,0,0
,,Alaska,58,46,12,0,57,45,12,0,49,39,10,0,27,25,2,0,31,25,6,0,16,12,4,0,0,0,0,0
,,Arizona,303,204,99,0,298,200,98,0,271,180,91,0,158,110,48,0,120,73,47,0,80,55,25,0,5,4,1,0
,,Arkansas,177,118,59,0,172,115,57,0,153,101,52,0,108,77,31,0,59,41,18,0,50,25,25,0,6,3,3,0
,,California,1494,1062,432,0,1453,1033,420,0,1347,958,389,0,946,706,240,0,692,511,181,0,427,303,124,0,22,12,10,0
,,Colorado,291,194,97,0,284,190,94,0,268,181,87,0,185,128,57,0,156,103,53,0,76,48,28,0,6,4,2,0
,,Connecticut,130,97,33,0,124,92,32,0,104,75,29,0,77,58,19,0,50,36,14,0,21,14,7,0,1,0,1,0
,,Delaware,53,35,18,0,51,34,17,0,46,30,16,0,22,15,7,0,23,12,11,0,11,7,4,0,1,1,0,0
,,District of Columbia,32,25,7,0,31,24,7,0,29,23,6,0,22,19,3,0,24,19,5,0,9,5,4,0,0,0,0,0
,,Florida,955,628,327,0,935,615,320,0,826,547,279,0,513,368,145,0,422,293,129,0,252,170,82,0,63,38,25,0
,,Georgia,497,344,153,0,489,338,151,0,438,308,130,0,310,227,83,0,197,148,49,0,133,97,36,0,12,5,7,0
,,Hawaii,35,27,8,0,34,26,8,0,32,25,7,0,9,8,1,0,13,10,3,0,2,2,0,0,0,0,0,0
,,Idaho,111,72,39,0,108,70,38,0,100,66,34,0,72,50,22,0,55,39,16,0,24,15,9,0,4,1,3,0
,,Illinois,717,505,212,0,704,499,205,0,623,439,184,0,380,288,92,0,386,285,101,0,236,172,64,0,14,8,6,0
,,Indiana,412,286,126,0,405,280,125,0,379,261,118,0,272,197,75,0,234,160,74,0,121,82,39,0,39,25,14,0
,,Iowa,204,119,85,0,198,113,85,0,187,112,75,0,106,67,39,0,113,74,39,0,57,34,23,0,3,0,3,0
,,Kansas,257,170,87,0,255,169,86,0,233,152,81,0,137,100,37,0,133,87,46,0,77,51,26,0,6,6,0,0
,,Kentucky,237,153,84,0,233,149,84,0,213,139,74,0,135,92,43,0,103,67,36,0,84,56,28,0,4,3,1,0
,,Louisiana,384,267,117,0,376,262,114,0,356,247,109,0,246,180,66,0,210,144,66,0,125,96,29,0,16,11,5,0
,,Maine,69,44,25,0,67,42,25,0,61,37,24,0,37,28,9,0,33,19,14,0,7,5,2,0,1,1,0,0
,,Maryland,264,176,88,0,258,172,86,0,232,158,74,0,152,108,44,0,157,109,48,0,94,66,28,0,10,6,4,0
,,Massachusetts,213,144,69,0,208,141,67,0,167,116,51,0,113,81,32,0,81,54,27,0,42,25,17,0,3,1,2,0
,,Michigan,619,413,206,0,605,405,200,0,514,345,169,0,322,222,100,0,264,185,79,0,167,118,49,0,21,16,5,0
,,Minnesota,270,178,92,0,266,175,91,0,244,164,80,0,156,103,53,0,184,123,61,0,87,49,38,0,7,6,1,0
,,Mississippi,223,138,85,0,217,135,82,0,184,118,66,0,134,89,45,0,92,55,37,0,53,39,14,0,13,7,6,0
,,Missouri,437,289,148,0,426,283,143,0,398,263,135,0,264,190,74,0,192,133,59,0,143,101,42,0,13,7,6,0
,,,,,,,,,,,,,,,,,,,,,,,,,,,,,,
,,,,,,,,,,,,,,,,,,,,,,,,,,,,,,
,,Montana,78,51,27,0,78,51,27,0,71,47,24,0,46,34,12,0,36,24,12,0,19,14,5,0,0,0,0,0
,,Nebraska,132,77,55,0,131,76,55,0,124,74,50,0,68,42,26,0,86,55,31,0,33,22,11,0,6,6,0,0
,,Nevada,140,88,52,0,139,87,52,0,131,82,49,0,91,58,33,0,61,39,22,0,38,22,16,0,5,3,2,0
,,New Hampshire,55,41,14,0,53,40,13,0,43,31,12,0,27,21,6,0,27,19,8,0,12,9,3,0,0,0,0,0
,,New Jersey,284,191,93,0,280,190,90,0,244,162,82,0,161,110,51,0,142,100,42,0,70,42,28,0,5,2,3,0
,,New Mexico,136,94,42,0,132,91,41,0,115,80,35,0,78,56,22,0,31,20,11,0,35,25,10,0,3,2,1,0
,,New York,596,386,210,0,578,371,207,0,502,330,172,0,350,240,110,0,252,164,88,0,130,84,46,0,22,15,7,0
,,North Carolina,456,306,150,0,449,300,149,0,393,259,134,0,262,188,74,0,248,170,78,0,128,87,41,0,7,4,3,0
,,North Dakota,45,29,16,0,44,29,15,0,40,26,14,0,24,20,4,0,30,20,10,0,11,5,6,0,1,1,0,0
,,Ohio,630,429,201,0,622,425,197,0,552,388,164,0,364,270,94,0,364,263,101,0,199,140,59,0,21,12,9,0
,,Oklahoma,282,196,86,0,275,190,85,0,253,177,76,0,160,111,49,0,77,58,19,0,64,47,17,0,2,2,0,0
,,Oregon,189,121,68,0,188,120,68,0,169,109,60,0,91,68,23,0,78,59,19,0,38,27,11,0,1,1,0,0
,,Pennsylvania,691,483,208,0,675,471,204,0,611,435,176,0,386,280,106,0,365,263,102,0,210,149,61,0,24,17,7,0
,,Puerto Rico,111,87,24,0,110,86,24,0,89,70,19,0,48,41,7,0,41,28,13,0,27,19,8,0,5,4,1,0
,,Rhode Island,23,19,4,0,21,17,4,0,19,16,3,0,16,13,3,0,13,10,3,0,4,4,0,0,0,0,0,0
,,South Carolina,273,190,83,0,271,188,83,0,246,172,74,0,178,137,41,0,133,98,35,0,86,68,18,0,4,3,1,0
,,South Dakota,51,29,22,0,51,29,22,0,45,26,19,0,27,18,9,0,36,21,15,0,23,15,8,0,2,1,1,0
,,State unassigned,273,196,77,0,265,193,72,0,212,158,54,0,154,114,40,0,79,63,16,0,54,36,18,0,3,1,2,0
,,Tennessee,403,263,140,0,393,256,137,0,348,231,117,0,247,183,64,0,210,143,67,0,124,86,38,0,11,8,3,0
,,Texas,1499,1013,486,0,1458,985,473,0,1308,892,416,0,929,664,265,0,523,376,147,0,440,311,129,0,19,15,4,0
,,Utah,195,124,71,0,189,122,67,0,167,108,59,0,94,55,39,0,78,50,28,0,38,25,13,0,2,2,0,0
,,Vermont,35,24,11,0,35,24,11,0,32,23,9,0,20,14,6,0,13,9,4,0,9,7,2,0,1,0,1,0
,,Virginia,356,259,97,0,348,252,96,0,313,226,87,0,209,156,53,0,153,111,42,0,98,72,26,0,8,5,3,0
,,Washington,277,184,93,0,270,180,90,0,251,165,86,0,149,109,40,0,121,85,36,0,65,41,24,0,2,2,0,0
,,West Virginia,118,78,40,0,117,77,40,0,103,66,37,0,62,46,16,0,61,42,19,0,31,23,8,0,4,4,0,0
,,Wisconsin,364,234,130,0,363,234,129,0,328,210,118,0,204,136,68,0,273,173,100,0,89,55,34,0,7,5,2,0
,,Wyoming,47,38,9,0,45,36,9,0,41,32,9,0,35,29,6,0,23,19,4,0,14,11,3,0,0,0,0,0
,18-34 Years,All Donor States of Residence,63600,44564,19036,0,60738,42728,18010,0,54491,38498,15993,0,35804,27252,8552,0,24101,17814,6287,0,17176,12092,5084,0,803,522,281,0
,,Alabama,1170,817,353,0,1128,790,338,0,1004,715,289,0,627,483,144,0,363,281,82,0,298,220,78,0,4,3,1,0
,,Alaska,209,151,58,0,205,147,58,0,182,136,46,0,111,91,20,0,88,73,15,0,66,52,14,0,0,0,0,0
,,Arizona,1248,903,345,0,1220,887,333,0,1089,803,286,0,668,519,149,0,410,314,96,0,369,260,109,0,10,9,1,0
,,Arkansas,699,484,215,0,665,460,205,0,608,423,185,0,421,314,107,0,246,175,71,0,197,128,69,0,23,16,7,0
,,California,6324,4617,1707,0,6091,4454,1637,0,5545,4060,1485,0,3934,3108,826,0,2349,1774,575,0,1812,1314,498,0,25,14,11,0
,,Colorado,925,628,297,0,899,609,290,0,812,560,252,0,531,404,127,0,354,253,101,0,230,154,76,0,4,3,1,0
,,Connecticut,553,402,151,0,533,389,144,0,460,336,124,0,303,240,63,0,181,141,40,0,108,80,28,0,5,4,1,0
,,Delaware,269,190,79,0,259,180,79,0,224,157,67,0,152,114,38,0,115,88,27,0,83,62,21,0,4,3,1,0
,,District of Columbia,161,131,30,0,157,128,29,0,135,111,24,0,104,87,17,0,95,79,16,0,57,45,12,0,4,3,1,0
,,Florida,4131,2904,1227,0,3901,2756,1145,0,3581,2548,1033,0,2182,1649,533,0,1458,1085,373,0,1062,730,332,0,87,54,33,0
,,Georgia,1769,1213,556,0,1636,1122,514,0,1554,1081,473,0,1089,814,275,0,567,422,145,0,511,350,161,0,21,12,9,0
,,Hawaii,195,153,42,0,193,152,41,0,154,121,33,0,31,25,6,0,64,54,10,0,14,8,6,0,0,0,0,0
,,Idaho,270,188,82,0,261,183,78,0,237,167,70,0,152,117,35,0,93,73,20,0,65,46,19,0,1,0,1,0
,,,,,,,,,,,,,,,,,,,,,,,,,,,,,,
,,,,,,,,,,,,,,,,,,,,,,,,,,,,,,
,,Illinois,2598,1851,747,0,2479,1779,700,0,2163,1542,621,0,1384,1065,319,0,1251,919,332,0,758,546,212,0,30,26,4,0
,,Indiana,1523,1048,475,0,1448,997,451,0,1351,931,420,0,884,667,217,0,582,426,156,0,468,325,143,0,87,58,29,0
,,Iowa,550,377,173,0,536,369,167,0,479,326,153,0,295,220,75,0,246,177,69,0,150,106,44,0,6,4,2,0
,,Kansas,758,537,221,0,736,521,215,0,653,462,191,0,401,310,91,0,318,229,89,0,213,153,60,0,8,4,4,0
,,Kentucky,936,657,279,0,891,625,266,0,810,571,239,0,513,393,120,0,386,287,99,0,236,183,53,0,7,5,2,0
,,Louisiana,1296,918,378,0,1213,864,349,0,1181,844,337,0,750,592,158,0,529,404,125,0,372,263,109,0,12,11,1,0
,,Maine,284,195,89,0,277,191,86,0,240,167,73,0,157,118,39,0,99,72,27,0,62,45,17,0,3,3,0,0
,,Maryland,1229,866,363,0,1178,837,341,0,1088,764,324,0,677,521,156,0,629,466,163,0,403,289,114,0,16,12,4,0
,,Massachusetts,1028,718,310,0,979,688,291,0,837,582,255,0,530,395,135,0,295,226,69,0,198,146,52,0,9,6,3,0
,,Michigan,2127,1449,678,0,2038,1401,637,0,1708,1194,514,0,1094,814,280,0,682,511,171,0,604,423,181,0,37,21,16,0
,,Minnesota,900,620,280,0,877,603,274,0,787,545,242,0,537,385,152,0,577,404,173,0,263,176,87,0,24,16,8,0
,,Mississippi,577,387,190,0,553,372,181,0,475,330,145,0,303,221,82,0,197,147,50,0,141,99,42,0,8,7,1,0
,,Missouri,1651,1150,501,0,1551,1084,467,0,1420,1003,417,0,907,676,231,0,601,442,159,0,553,386,167,0,27,17,10,0
,,Montana,202,146,56,0,195,142,53,0,176,129,47,0,125,98,27,0,87,68,19,0,42,30,12,0,3,2,1,0
,,Nebraska,363,247,116,0,353,243,110,0,321,221,100,0,215,153,62,0,178,121,57,0,103,66,37,0,8,2,6,0
,,Nevada,528,359,169,0,499,337,162,0,457,309,148,0,299,227,72,0,171,124,47,0,140,96,44,0,3,2,1,0
,,New Hampshire,204,133,71,0,194,127,67,0,168,113,55,0,107,77,30,0,71,45,26,0,45,26,19,0,2,2,0,0
,,New Jersey,1413,942,471,0,1348,905,443,0,1179,795,384,0,780,564,216,0,560,380,180,0,331,221,110,0,6,3,3,0
,,New Mexico,514,364,150,0,492,352,140,0,423,297,126,0,274,214,60,0,123,93,30,0,101,71,30,0,7,5,2,0
,,New York,2617,1804,813,0,2458,1712,746,0,2198,1526,672,0,1424,1078,346,0,880,631,249,0,441,299,142,0,23,14,9,0
,,North Carolina,1883,1334,549,0,1784,1268,516,0,1602,1136,466,0,1088,845,243,0,802,585,217,0,571,419,152,0,26,18,8,0
,,North Dakota,136,92,44,0,132,91,41,0,121,80,41,0,74,54,20,0,77,52,25,0,34,20,14,0,2,2,0,0
,,Ohio,2655,1784,871,0,2516,1696,820,0,2253,1544,709,0,1364,989,375,0,1182,858,324,0,698,475,223,0,49,30,19,0
,,Oklahoma,901,634,267,0,850,600,250,0,759,532,227,0,487,363,124,0,230,172,58,0,218,160,58,0,4,1,3,0
,,Oregon,606,431,175,0,591,424,167,0,515,372,143,0,323,246,77,0,218,167,51,0,117,84,33,0,0,0,0,0
,,Pennsylvania,3285,2290,995,0,3152,2200,952,0,2821,1981,840,0,1753,1328,425,0,1339,967,372,0,979,674,305,0,61,40,21,0
,,Puerto Rico,508,381,127,0,485,368,117,0,448,340,108,0,238,202,36,0,173,137,36,0,123,99,24,0,16,11,5,0
,,Rhode Island,148,97,51,0,139,92,47,0,101,70,31,0,80,57,23,0,45,31,14,0,22,12,10,0,2,1,1,0
,,South Carolina,1035,733,302,0,994,712,282,0,915,652,263,0,646,512,134,0,419,321,98,0,314,236,78,0,7,4,3,0
,,South Dakota,161,106,55,0,158,105,53,0,143,94,49,0,91,67,24,0,98,65,33,0,46,30,16,0,3,1,2,0
,,State unassigned,1101,821,280,0,1039,777,262,0,834,626,208,0,654,524,130,0,363,286,77,0,218,166,52,0,8,3,5,0
,,Tennessee,1567,1089,478,0,1492,1041,451,0,1368,958,410,0,959,735,224,0,584,435,149,0,436,310,126,0,32,22,10,0
,,Texas,5211,3649,1562,0,4977,3496,1481,0,4436,3128,1308,0,3263,2471,792,0,1504,1140,364,0,1586,1107,479,0,34,24,10,0
,,Utah,593,391,202,0,565,373,192,0,503,345,158,0,316,233,83,0,206,147,59,0,133,87,46,0,1,0,1,0
,,Vermont,123,85,38,0,120,82,38,0,107,74,33,0,67,51,16,0,45,33,12,0,24,17,7,0,1,0,1,0
,,Virginia,1388,934,454,0,1330,897,433,0,1202,822,380,0,797,585,212,0,496,352,144,0,370,254,116,0,15,5,10,0
,,Washington,1062,744,318,0,1036,730,306,0,902,630,272,0,551,412,139,0,385,281,104,0,270,187,83,0,3,2,1,0
,,West Virginia,457,317,140,0,433,302,131,0,414,282,132,0,243,174,69,0,184,141,43,0,120,76,44,0,17,12,5,0
,,Wisconsin,1408,989,419,0,1355,958,397,0,1217,859,358,0,756,574,182,0,844,610,234,0,364,254,110,0,7,4,3,0
,,Wyoming,151,114,37,0,147,110,37,0,131,104,27,0,93,77,16,0,62,50,12,0,37,27,10,0,1,1,0,0
,35-49 Years,All Donor States of Residence,57545,32312,25233,0,53144,29686,23458,0,45397,25054,20343,0,19805,12096,7709,0,10231,5356,4875,0,10317,5128,5189,0,288,123,165,0
,,,,,,,,,,,,,,,,,,,,,,,,,,,,,,
,,,,,,,,,,,,,,,,,,,,,,,,,,,,,,
,,Alabama,903,512,391,0,837,474,363,0,719,389,330,0,236,150,86,0,78,43,35,0,125,67,58,0,2,0,2,0
,,Alaska,187,102,85,0,183,99,84,0,133,73,60,0,47,32,15,0,24,18,6,0,36,17,19,0,0,0,0,0
,,Arizona,946,548,398,0,905,524,381,0,760,437,323,0,319,197,122,0,125,70,55,0,183,100,83,0,3,1,2,0
,,Arkansas,549,284,265,0,517,264,253,0,455,229,226,0,168,109,59,0,76,40,36,0,68,27,41,0,5,1,4,0
,,California,5987,3516,2471,0,5606,3277,2329,0,4729,2740,1989,0,2180,1359,821,0,892,469,423,0,1193,648,545,0,8,2,6,0
,,Colorado,820,443,377,0,765,415,350,0,661,358,303,0,326,197,129,0,176,90,86,0,127,59,68,0,6,1,5,0
,,Connecticut,566,337,229,0,535,317,218,0,443,262,181,0,228,157,71,0,91,49,42,0,82,54,28,0,1,1,0,0
,,Delaware,283,177,106,0,258,162,96,0,229,140,89,0,103,66,37,0,48,29,19,0,74,43,31,0,6,4,2,0
,,District of Columbia,138,74,64,0,125,66,59,0,109,59,50,0,42,23,19,0,30,13,17,0,26,10,16,0,0,0,0,0
,,Florida,3666,2086,1580,0,3352,1903,1449,0,2858,1603,1255,0,1148,700,448,0,517,256,261,0,633,304,329,0,38,16,22,0
,,Georgia,1682,859,823,0,1449,721,728,0,1378,703,675,0,538,314,224,0,148,80,68,0,290,129,161,0,6,3,3,0
,,Hawaii,271,172,99,0,257,165,92,0,192,116,76,0,22,17,5,0,30,18,12,0,12,4,8,0,0,0,0,0
,,Idaho,234,136,98,0,218,125,93,0,182,111,71,0,77,49,28,0,40,21,19,0,36,24,12,0,0,0,0,0
,,Illinois,2370,1345,1025,0,2198,1246,952,0,1755,966,789,0,755,447,308,0,639,320,319,0,454,217,237,0,8,4,4,0
,,Indiana,1290,696,594,0,1187,635,552,0,1095,587,508,0,503,314,189,0,283,149,134,0,236,113,123,0,24,7,17,0
,,Iowa,482,264,218,0,460,253,207,0,397,211,186,0,176,100,76,0,132,63,69,0,93,31,62,0,2,1,1,0
,,Kansas,643,386,257,0,611,367,244,0,498,284,214,0,235,151,84,0,147,82,65,0,124,66,58,0,3,1,2,0
,,Kentucky,800,464,336,0,746,422,324,0,647,364,283,0,268,171,97,0,138,67,71,0,145,66,79,0,1,0,1,0
,,Louisiana,1032,559,473,0,897,490,407,0,898,490,408,0,303,178,125,0,168,94,74,0,202,97,105,0,3,0,3,0
,,Maine,250,159,91,0,232,150,82,0,185,115,70,0,86,59,27,0,50,32,18,0,32,19,13,0,2,1,1,0
,,Maryland,1199,677,522,0,1090,612,478,0,976,550,426,0,406,227,179,0,298,168,130,0,283,148,135,0,7,4,3,0
,,Massachusetts,1065,623,442,0,994,580,414,0,766,442,324,0,403,242,161,0,180,103,77,0,154,83,71,0,2,1,1,0
,,Michigan,2084,1152,932,0,1931,1066,865,0,1525,832,693,0,670,397,273,0,317,162,155,0,445,211,234,0,12,4,8,0
,,Minnesota,877,481,396,0,830,452,378,0,741,397,344,0,341,199,142,0,398,209,189,0,201,107,94,0,15,8,7,0
,,Mississippi,532,302,230,0,494,277,217,0,409,228,181,0,149,96,53,0,61,32,29,0,69,36,33,0,2,0,2,0
,,Missouri,1315,699,616,0,1166,619,547,0,1045,548,497,0,410,238,172,0,219,110,109,0,293,143,150,0,5,4,1,0
,,Montana,173,96,77,0,165,94,71,0,139,73,66,0,66,43,23,0,32,16,16,0,24,8,16,0,0,0,0,0
,,Nebraska,302,143,159,0,287,136,151,0,265,124,141,0,92,49,43,0,100,48,52,0,47,17,30,0,0,0,0,0
,,Nevada,519,281,238,0,484,260,224,0,416,220,196,0,191,105,86,0,60,38,22,0,101,45,56,0,0,0,0,0
,,New Hampshire,237,137,100,0,224,130,94,0,182,107,75,0,101,62,39,0,46,29,17,0,48,24,24,0,1,1,0,0
,,New Jersey,1523,888,635,0,1426,828,598,0,1144,646,498,0,541,319,222,0,276,147,129,0,219,105,114,0,3,1,2,0
,,New Mexico,351,182,169,0,334,171,163,0,260,126,134,0,113,65,48,0,29,11,18,0,34,16,18,0,2,2,0,0
,,New York,2750,1510,1240,0,2437,1337,1100,0,2213,1182,1031,0,977,583,394,0,444,232,212,0,296,139,157,0,17,8,9,0
,,North Carolina,1592,894,698,0,1482,818,664,0,1238,679,559,0,630,387,243,0,333,176,157,0,341,174,167,0,11,3,8,0
,,North Dakota,117,69,48,0,116,69,47,0,82,45,37,0,45,30,15,0,52,32,20,0,18,8,10,0,2,1,1,0
,,Ohio,2400,1330,1070,0,2213,1211,1002,0,1921,1047,874,0,818,488,330,0,599,306,293,0,460,221,239,0,11,6,5,0
,,Oklahoma,818,434,384,0,749,389,360,0,614,319,295,0,267,155,112,0,61,36,25,0,114,65,49,0,1,1,0,0
,,Oregon,544,292,252,0,524,277,247,0,426,219,207,0,210,115,95,0,85,36,49,0,72,28,44,0,1,0,1,0
,,Pennsylvania,3226,1844,1382,0,2997,1698,1299,0,2596,1473,1123,0,1120,687,433,0,644,326,318,0,588,308,280,0,25,14,11,0
,,Puerto Rico,367,203,164,0,329,178,151,0,289,160,129,0,50,30,20,0,23,14,9,0,49,28,21,0,1,1,0,0
,,Rhode Island,144,72,72,0,135,67,68,0,109,55,54,0,49,25,24,0,32,17,15,0,15,3,12,0,0,0,0,0
,,,,,,,,,,,,,,,,,,,,,,,,,,,,,,
,,,,,,,,,,,,,,,,,,,,,,,,,,,,,,
,,South Carolina,1001,585,416,0,925,534,391,0,846,493,353,0,367,251,116,0,147,86,61,0,195,112,83,0,1,0,1,0
,,South Dakota,138,82,56,0,128,75,53,0,120,69,51,0,49,27,22,0,62,31,31,0,28,14,14,0,1,1,0,0
,,State unassigned,738,432,306,0,701,407,294,0,515,312,203,0,293,199,94,0,138,82,56,0,96,52,44,0,2,1,1,0
,,Tennessee,1417,772,645,0,1273,689,584,0,1181,630,551,0,544,330,214,0,245,123,122,0,255,124,131,0,14,4,10,0
,,Texas,4442,2471,1971,0,4025,2231,1794,0,3439,1871,1568,0,1594,1017,577,0,418,213,205,0,913,445,468,0,9,1,8,0
,,Utah,408,218,190,0,385,208,177,0,308,163,145,0,166,95,71,0,69,37,32,0,60,25,35,0,0,0,0,0
,,Vermont,98,39,59,0,93,36,57,0,70,26,44,0,28,11,17,0,22,9,13,0,17,6,11,0,0,0,0,0
,,Virginia,1300,745,555,0,1230,699,531,0,1045,585,460,0,452,284,168,0,188,103,85,0,248,130,118,0,13,8,5,0
,,Washington,950,527,423,0,918,508,410,0,722,396,326,0,300,174,126,0,166,83,83,0,155,70,85,0,2,0,2,0
,,West Virginia,409,215,194,0,381,197,184,0,342,180,162,0,119,80,39,0,85,40,45,0,64,33,31,0,7,4,3,0
,,Wisconsin,1326,751,575,0,1261,714,547,0,1062,584,478,0,456,277,179,0,554,290,264,0,234,101,133,0,3,2,1,0
,,Wyoming,84,47,37,0,79,44,35,0,68,36,32,0,28,19,9,0,16,8,8,0,10,4,6,0,0,0,0,0
,50-64 Years,All Donor States of Residence,53900,28577,25323,0,49048,25531,23517,0,40577,21055,19522,0,5767,3030,2737,0,2455,1107,1348,0,5892,2654,3238,0,52,25,27,0
,,Alabama,886,457,429,0,779,390,389,0,726,372,354,0,35,22,13,0,10,4,6,0,44,18,26,0,0,0,0,0
,,Alaska,100,57,43,0,97,54,43,0,74,38,36,0,10,5,5,0,2,2,0,0,10,4,6,0,0,0,0,0
,,Arizona,769,407,362,0,722,382,340,0,578,299,279,0,64,39,25,0,13,3,10,0,82,41,41,0,1,1,0,0
,,Arkansas,392,198,194,0,360,179,181,0,327,162,165,0,34,20,14,0,12,9,3,0,38,10,28,0,1,1,0,0
,,California,5692,3111,2581,0,5292,2859,2433,0,4267,2303,1964,0,743,410,333,0,157,68,89,0,764,367,397,0,2,2,0,0
,,Colorado,597,308,289,0,565,286,279,0,434,214,220,0,75,37,38,0,44,16,28,0,48,21,27,0,3,1,2,0
,,Connecticut,487,273,214,0,453,250,203,0,350,186,164,0,73,32,41,0,19,7,12,0,41,26,15,0,0,0,0,0
,,Delaware,263,133,130,0,240,120,120,0,198,99,99,0,36,17,19,0,13,8,5,0,23,9,14,0,0,0,0,0
,,District of Columbia,156,75,81,0,131,57,74,0,119,57,62,0,5,2,3,0,3,1,2,0,14,3,11,0,0,0,0,0
,,Florida,3564,1857,1707,0,3177,1608,1569,0,2685,1387,1298,0,280,145,135,0,76,33,43,0,351,138,213,0,6,1,5,0
,,Georgia,1584,805,779,0,1325,641,684,0,1298,664,634,0,140,78,62,0,12,7,5,0,185,84,101,0,0,0,0,0
,,Hawaii,227,131,96,0,220,128,92,0,163,93,70,0,4,3,1,0,1,1,0,0,4,1,3,0,0,0,0,0
,,Idaho,189,106,83,0,184,102,82,0,136,70,66,0,20,10,10,0,4,1,3,0,18,11,7,0,0,0,0,0
,,Illinois,2513,1387,1126,0,2246,1219,1027,0,1779,950,829,0,234,121,113,0,274,127,147,0,313,160,153,0,7,7,0,0
,,Indiana,963,483,480,0,878,437,441,0,781,378,403,0,124,66,58,0,46,19,27,0,138,56,82,0,0,0,0,0
,,Iowa,457,252,205,0,429,237,192,0,352,191,161,0,65,37,28,0,39,23,16,0,38,13,25,0,0,0,0,0
,,Kansas,524,293,231,0,482,266,216,0,406,225,181,0,56,39,17,0,33,18,15,0,62,30,32,0,1,0,1,0
,,Kentucky,644,345,299,0,602,313,289,0,517,279,238,0,70,34,36,0,34,13,21,0,66,26,40,0,0,0,0,0
,,Louisiana,879,468,411,0,740,384,356,0,776,410,366,0,53,28,25,0,17,7,10,0,93,41,52,0,0,0,0,0
,,Maine,220,124,96,0,213,118,95,0,142,80,62,0,30,17,13,0,16,8,8,0,20,9,11,0,0,0,0,0
,,Maryland,1236,636,600,0,1105,559,546,0,978,503,475,0,110,55,55,0,40,13,27,0,184,85,99,0,3,0,3,0
,,Massachusetts,967,532,435,0,915,495,420,0,634,328,306,0,140,69,71,0,45,24,21,0,87,41,46,0,1,1,0,0
,,Michigan,2040,1076,964,0,1888,986,902,0,1351,696,655,0,224,118,106,0,90,46,44,0,257,105,152,0,1,1,0,0
,,Minnesota,834,452,382,0,797,427,370,0,656,350,306,0,141,73,68,0,167,80,87,0,101,49,52,0,8,4,4,0
,,Mississippi,479,242,237,0,438,216,222,0,373,185,188,0,41,18,23,0,10,4,6,0,38,14,24,0,0,0,0,0
,,Missouri,1293,673,620,0,1135,585,550,0,1041,524,517,0,106,49,57,0,65,25,40,0,173,83,90,0,1,0,1,0
,,Montana,143,61,82,0,139,59,80,0,101,40,61,0,20,6,14,0,8,4,4,0,14,4,10,0,0,0,0,0
,,Nebraska,319,161,158,0,298,150,148,0,246,119,127,0,28,14,14,0,35,16,19,0,34,16,18,0,0,0,0,0
,,,,,,,,,,,,,,,,,,,,,,,,,,,,,,
,,,,,,,,,,,,,,,,,,,,,,,,,,,,,,
,,Nevada,536,270,266,0,483,239,244,0,415,210,205,0,58,33,25,0,9,3,6,0,48,17,31,0,0,0,0,0
,,New Hampshire,220,109,111,0,207,103,104,0,151,72,79,0,29,11,18,0,12,5,7,0,27,6,21,0,0,0,0,0
,,New Jersey,1593,811,782,0,1465,729,736,0,1172,589,583,0,169,79,90,0,83,37,46,0,131,61,70,0,0,0,0,0
,,New Mexico,282,128,154,0,261,114,147,0,200,91,109,0,27,10,17,0,8,1,7,0,15,6,9,0,0,0,0,0
,,New York,2997,1654,1343,0,2634,1410,1224,0,2250,1212,1038,0,307,174,133,0,103,42,61,0,189,81,108,0,1,0,1,0
,,North Carolina,1478,747,731,0,1354,669,685,0,1050,504,546,0,237,111,126,0,57,24,33,0,219,95,124,0,1,0,1,0
,,North Dakota,94,53,41,0,88,50,38,0,78,42,36,0,11,7,4,0,16,6,10,0,12,5,7,0,1,0,1,0
,,Ohio,2176,1127,1049,0,1995,1013,982,0,1657,841,816,0,222,106,116,0,145,63,82,0,251,96,155,0,2,1,1,0
,,Oklahoma,678,354,324,0,630,332,298,0,477,230,247,0,65,39,26,0,12,7,5,0,44,18,26,0,0,0,0,0
,,Oregon,472,236,236,0,456,227,229,0,374,180,194,0,62,31,31,0,23,12,11,0,32,11,21,0,1,0,1,0
,,Pennsylvania,3450,1920,1530,0,3166,1734,1432,0,2641,1428,1213,0,458,257,201,0,231,104,127,0,391,194,197,0,3,3,0,0
,,Puerto Rico,593,315,278,0,501,254,247,0,446,234,212,0,3,2,1,0,0,0,0,0,44,27,17,0,0,0,0,0
,,Rhode Island,129,71,58,0,123,67,56,0,85,41,44,0,24,11,13,0,9,4,5,0,13,7,6,0,0,0,0,0
,,South Carolina,880,459,421,0,814,423,391,0,741,373,368,0,101,50,51,0,14,8,6,0,116,50,66,0,0,0,0,0
,,South Dakota,113,58,55,0,110,55,55,0,93,48,45,0,13,4,9,0,21,12,9,0,15,5,10,0,1,0,1,0
,,State unassigned,646,325,321,0,602,294,308,0,431,213,218,0,78,37,41,0,38,15,23,0,61,30,31,0,1,1,0,0
,,Tennessee,1147,566,581,0,1020,478,542,0,917,436,481,0,125,55,70,0,44,21,23,0,132,54,78,0,1,1,0,0
,,Texas,3702,1933,1769,0,3256,1656,1600,0,2780,1431,1349,0,304,171,133,0,61,24,37,0,430,202,228,0,0,0,0,0
,,Utah,299,156,143,0,268,141,127,0,210,111,99,0,46,23,23,0,8,4,4,0,21,14,7,0,0,0,0,0
,,Vermont,83,52,31,0,80,50,30,0,53,33,20,0,14,8,6,0,2,1,1,0,10,5,5,0,0,0,0,0
,,Virginia,1221,657,564,0,1149,610,539,0,923,498,425,0,146,76,70,0,39,17,22,0,160,77,83,0,1,0,1,0
,,Washington,811,432,379,0,781,411,370,0,571,303,268,0,106,51,55,0,35,16,19,0,95,36,59,0,1,0,1,0
,,West Virginia,383,184,199,0,353,166,187,0,304,142,162,0,28,11,17,0,34,14,20,0,39,16,23,0,2,0,2,0
,,Wisconsin,1411,813,598,0,1316,758,558,0,1000,558,442,0,161,102,59,0,157,76,81,0,145,72,73,0,1,0,1,0
,,Wyoming,89,44,45,0,86,41,45,0,70,33,37,0,12,7,5,0,9,4,5,0,12,4,8,0,0,0,0,0
,65 +,All Donor States of Residence,15974,7593,8381,0,11938,5487,6451,0,13628,6497,7131,0,126,49,77,0,106,47,59,0,459,186,273,0,6,2,4,0
,,Alabama,214,117,97,0,176,89,87,0,181,99,82,0,0,0,0,0,0,0,0,0,5,1,4,0,0,0,0,0
,,Alaska,16,7,9,0,13,5,8,0,13,6,7,0,0,0,0,0,1,1,0,0,0,0,0,0,0,0,0,0
,,Arizona,229,104,125,0,196,85,111,0,186,86,100,0,0,0,0,0,1,0,1,0,3,1,2,0,0,0,0,0
,,Arkansas,95,41,54,0,73,32,41,0,87,39,48,0,0,0,0,0,0,0,0,0,5,1,4,0,0,0,0,0
,,California,1332,624,708,0,1140,514,626,0,1054,492,562,0,20,7,13,0,14,5,9,0,67,25,42,0,0,0,0,0
,,Colorado,127,56,71,0,104,43,61,0,102,45,57,0,3,0,3,0,4,0,4,0,5,2,3,0,0,0,0,0
,,Connecticut,126,51,75,0,105,40,65,0,110,45,65,0,6,1,5,0,0,0,0,0,6,3,3,0,0,0,0,0
,,Delaware,115,56,59,0,91,42,49,0,100,47,53,0,1,1,0,0,1,0,1,0,5,3,2,0,0,0,0,0
,,District of Columbia,49,21,28,0,37,14,23,0,41,18,23,0,0,0,0,0,0,0,0,0,4,3,1,0,0,0,0,0
,,Florida,1254,576,678,0,819,374,445,0,1070,496,574,0,3,1,2,0,3,2,1,0,21,8,13,0,1,0,1,0
,,Georgia,464,203,261,0,296,114,182,0,417,178,239,0,0,0,0,0,0,0,0,0,11,2,9,0,0,0,0,0
,,Hawaii,25,7,18,0,25,7,18,0,9,2,7,0,0,0,0,0,0,0,0,0,0,0,0,0,0,0,0,0
,,Idaho,17,8,9,0,14,6,8,0,14,8,6,0,0,0,0,0,0,0,0,0,0,0,0,0,0,0,0,0
,,Illinois,795,404,391,0,552,269,283,0,649,335,314,0,13,7,6,0,14,7,7,0,30,14,16,0,3,2,1,0
,,Indiana,208,100,108,0,174,80,94,0,182,88,94,0,0,0,0,0,1,0,1,0,10,5,5,0,0,0,0,0
,,,,,,,,,,,,,,,,,,,,,,,,,,,,,,
,,,,,,,,,,,,,,,,,,,,,,,,,,,,,,
,,Iowa,101,58,43,0,86,50,36,0,89,48,41,0,2,1,1,0,2,1,1,0,3,1,2,0,0,0,0,0
,,Kansas,169,79,90,0,112,50,62,0,159,73,86,0,0,0,0,0,1,1,0,0,6,1,5,0,0,0,0,0
,,Kentucky,100,46,54,0,85,39,46,0,86,42,44,0,2,0,2,0,3,2,1,0,2,1,1,0,0,0,0,0
,,Louisiana,165,78,87,0,105,44,61,0,151,72,79,0,0,0,0,0,2,1,1,0,5,2,3,0,0,0,0,0
,,Maine,64,34,30,0,55,28,27,0,51,26,25,0,0,0,0,0,1,0,1,0,1,0,1,0,0,0,0,0
,,Maryland,429,215,214,0,359,171,188,0,355,183,172,0,0,0,0,0,1,0,1,0,16,11,5,0,0,0,0,0
,,Massachusetts,319,165,154,0,273,137,136,0,262,134,128,0,1,0,1,0,1,1,0,0,13,7,6,0,0,0,0,0
,,Michigan,446,205,241,0,356,156,200,0,344,154,190,0,3,2,1,0,1,1,0,0,34,8,26,0,0,0,0,0
,,Minnesota,275,125,150,0,216,95,121,0,240,107,133,0,4,1,3,0,7,2,5,0,5,4,1,0,0,0,0,0
,,Mississippi,126,63,63,0,95,45,50,0,106,57,49,0,0,0,0,0,0,0,0,0,0,0,0,0,0,0,0,0
,,Missouri,413,210,203,0,246,119,127,0,393,201,192,0,1,1,0,0,5,4,1,0,15,7,8,0,0,0,0,0
,,Montana,21,8,13,0,16,5,11,0,16,7,9,0,0,0,0,0,1,0,1,0,2,1,1,0,0,0,0,0
,,Nebraska,72,31,41,0,59,23,36,0,63,24,39,0,1,1,0,0,1,1,0,0,2,0,2,0,0,0,0,0
,,Nevada,145,70,75,0,115,52,63,0,132,65,67,0,1,1,0,0,1,1,0,0,8,4,4,0,0,0,0,0
,,New Hampshire,58,31,27,0,50,26,24,0,44,26,18,0,0,0,0,0,0,0,0,0,2,1,1,0,0,0,0,0
,,New Jersey,495,243,252,0,423,206,217,0,421,206,215,0,3,0,3,0,2,0,2,0,7,4,3,0,0,0,0,0
,,New Mexico,71,33,38,0,57,26,31,0,62,28,34,0,0,0,0,0,1,0,1,0,2,0,2,0,0,0,0,0
,,New York,1487,683,804,0,852,388,464,0,1358,620,738,0,4,1,3,0,6,4,2,0,16,6,10,0,0,0,0,0
,,North Carolina,404,190,214,0,311,139,172,0,330,161,169,0,7,4,3,0,3,1,2,0,24,10,14,0,0,0,0,0
,,North Dakota,33,17,16,0,24,10,14,0,28,15,13,0,0,0,0,0,1,1,0,0,0,0,0,0,0,0,0,0
,,Ohio,529,266,263,0,440,216,224,0,433,218,215,0,10,2,8,0,1,0,1,0,21,5,16,0,0,0,0,0
,,Oklahoma,151,71,80,0,123,54,69,0,124,59,65,0,1,1,0,0,0,0,0,0,4,0,4,0,0,0,0,0
,,Oregon,72,26,46,0,69,24,45,0,67,22,45,0,0,0,0,0,1,0,1,0,2,1,1,0,0,0,0,0
,,Pennsylvania,1495,743,752,0,1211,579,632,0,1289,644,645,0,12,6,6,0,11,5,6,0,32,14,18,0,0,0,0,0
,,Puerto Rico,233,116,117,0,147,67,80,0,202,100,102,0,0,0,0,0,0,0,0,0,2,0,2,0,0,0,0,0
,,Rhode Island,35,22,13,0,29,19,10,0,27,17,10,0,0,0,0,0,0,0,0,0,1,0,1,0,0,0,0,0
,,South Carolina,264,116,148,0,214,86,128,0,244,108,136,0,3,2,1,0,1,0,1,0,10,6,4,0,0,0,0,0
,,South Dakota,43,19,24,0,37,16,21,0,42,18,24,0,1,0,1,0,3,1,2,0,3,1,2,0,1,0,1,0
,,State unassigned,195,85,110,0,162,74,88,0,147,66,81,0,2,1,1,0,1,1,0,0,5,3,2,0,0,0,0,0
,,Tennessee,333,151,182,0,269,123,146,0,298,134,164,0,3,1,2,0,1,0,1,0,2,0,2,0,0,0,0,0
,,Texas,1017,472,545,0,577,260,317,0,878,415,463,0,7,4,3,0,2,1,1,0,16,7,9,0,0,0,0,0
,,Utah,49,31,18,0,39,24,15,0,48,31,17,0,1,0,1,0,0,0,0,0,0,0,0,0,0,0,0,0
,,Vermont,38,20,18,0,34,18,16,0,34,19,15,0,0,0,0,0,0,0,0,0,0,0,0,0,0,0,0,0
,,Virginia,393,170,223,0,332,141,191,0,334,142,192,0,4,2,2,0,1,1,0,0,11,4,7,0,1,0,1,0
,,Washington,148,65,83,0,127,53,74,0,120,55,65,0,0,0,0,0,1,0,1,0,3,1,2,0,0,0,0,0
,,West Virginia,133,60,73,0,105,47,58,0,119,52,67,0,0,0,0,0,1,0,1,0,3,2,1,0,0,0,0,0
,,Wisconsin,369,189,180,0,297,153,144,0,300,152,148,0,6,0,6,0,2,1,1,0,9,6,3,0,0,0,0,0
,,Wyoming,18,12,6,0,16,10,6,0,17,12,5,0,1,1,0,0,1,1,0,0,0,0,0,0,0,0,0,0
,Unknown,All Donor States of Residence,2,1,1,0,0,0,0,0,2,1,1,0,1,1,0,0,0,0,0,0,0,0,0,0,0,0,0,0
,,North Carolina,1,0,1,0,0,0,0,0,1,0,1,0,0,0,0,0,0,0,0,0,0,0,0,0,0,0,0,0
,,State unassigned,1,1,0,0,0,0,0,0,1,1,0,0,1,1,0,0,0,0,0,0,0,0,0,0,0,0,0,0
,,,,,,,,,,,,,,,,,,,,,,,,,,,,,,
,,,,,,,,,,,,,,,,,,,,,,,,,,,,,,
Living Donor,All Ages,All Donor States of Residence,165076,66889,98186,1,157281,63077,94203,1,7210,3462,3748,0,43,20,23,0,72,26,46,0,478,301,177,0,44,23,21,0
,,Alabama,2588,1033,1555,0,2562,1017,1545,0,20,13,7,0,2,1,1,0,1,0,1,0,3,2,1,0,0,0,0,0
,,Alaska,386,161,225,0,375,156,219,0,9,4,5,0,1,0,1,0,0,0,0,0,1,1,0,0,0,0,0,0
,,Arizona,3236,1277,1959,0,3073,1193,1880,0,136,65,71,0,2,1,1,0,0,0,0,0,25,18,7,0,0,0,0,0
,,Arkansas,1065,417,648,0,1033,402,631,0,25,12,13,0,0,0,0,0,1,0,1,0,6,3,3,0,0,0,0,0
,,California,17042,6934,10108,0,16025,6428,9597,0,876,417,459,0,9,4,5,0,1,0,1,0,129,84,45,0,2,1,1,0
,,Colorado,2799,1211,1588,0,2601,1114,1487,0,192,92,100,0,0,0,0,0,0,0,0,0,5,4,1,0,1,1,0,0
,,Connecticut,2095,839,1256,0,1975,783,1192,0,118,54,64,0,0,0,0,0,1,1,0,0,2,2,0,0,0,0,0,0
,,Delaware,472,176,296,0,446,164,282,0,26,12,14,0,0,0,0,0,1,1,0,0,0,0,0,0,0,0,0,0
,,District of Columbia,474,219,255,0,453,212,241,0,20,7,13,0,0,0,0,0,0,0,0,0,1,0,1,0,0,0,0,0
,,Florida,6207,2482,3725,0,6055,2412,3643,0,131,63,68,0,1,1,0,0,2,1,1,0,19,5,14,0,0,0,0,0
,,Georgia,4071,1524,2547,0,3971,1486,2485,0,93,34,59,0,1,1,0,0,2,1,1,0,4,2,2,0,0,0,0,0
,,Hawaii,512,217,295,0,494,210,284,0,18,7,11,0,0,0,0,0,0,0,0,0,0,0,0,0,0,0,0,0
,,Idaho,746,292,454,0,718,279,439,0,26,13,13,0,2,0,2,0,0,0,0,0,0,0,0,0,0,0,0,0
,,Illinois,8361,3526,4835,0,7898,3304,4594,0,438,206,232,0,0,0,0,0,8,3,5,0,6,4,2,0,20,12,8,0
,,Indiana,3159,1238,1921,0,3081,1202,1879,0,66,31,35,0,0,0,0,0,1,0,1,0,8,4,4,0,3,1,2,0
,,Iowa,1876,768,1108,0,1819,740,1079,0,51,25,26,0,0,0,0,0,2,1,1,0,5,3,2,0,1,0,1,0
,,Kansas,1088,431,657,0,1053,408,645,0,30,18,12,0,0,0,0,0,1,0,1,0,5,5,0,0,0,0,0,0
,,Kentucky,1829,706,1123,0,1787,684,1103,0,40,21,19,0,0,0,0,0,2,1,1,0,1,0,1,0,0,0,0,0
,,Louisiana,1906,781,1125,0,1863,757,1106,0,39,22,17,0,0,0,0,0,0,0,0,0,2,1,1,0,2,1,1,0
,,Maine,836,341,495,0,761,300,461,0,65,36,29,0,0,0,0,0,1,0,1,0,10,5,5,0,0,0,0,0
,,Maryland,4371,1714,2657,0,4120,1567,2553,0,248,146,102,0,0,0,0,0,1,0,1,0,3,1,2,0,0,0,0,0
,,Massachusetts,4230,1743,2487,0,3892,1572,2320,0,302,150,152,0,0,0,0,0,1,0,1,0,34,21,13,0,1,0,1,0
,,Michigan,6589,2646,3943,0,6366,2540,3826,0,214,102,112,0,1,0,1,0,0,0,0,0,7,3,4,0,1,1,0,0
,,Minnesota,5078,2147,2931,0,4832,2032,2800,0,225,106,119,0,3,0,3,0,20,8,12,0,11,7,4,0,4,2,2,0
,,Mississippi,1014,393,621,0,978,384,594,0,32,8,24,0,1,0,1,0,0,0,0,0,3,1,2,0,0,0,0,0
,,Missouri,2505,997,1508,0,2439,964,1475,0,62,30,32,0,0,0,0,0,0,0,0,0,4,3,1,0,0,0,0,0
,,Montana,560,218,342,0,535,202,333,0,23,14,9,0,1,1,0,0,0,0,0,0,1,1,0,0,0,0,0,0
,,Nebraska,1029,423,606,0,983,399,584,0,40,19,21,0,0,0,0,0,0,0,0,0,6,5,1,0,0,0,0,0
,,Nevada,980,426,554,0,933,400,533,0,39,19,20,0,0,0,0,0,0,0,0,0,8,7,1,0,0,0,0,0
,,New Hampshire,894,373,521,0,830,334,496,0,59,35,24,0,0,0,0,0,0,0,0,0,5,4,1,0,0,0,0,0
,,New Jersey,5532,2175,3357,0,5304,2072,3232,0,224,100,124,0,0,0,0,0,0,0,0,0,4,3,1,0,0,0,0,0
,,New Mexico,869,360,509,0,836,345,491,0,32,14,18,0,0,0,0,0,0,0,0,0,0,0,0,0,1,1,0,0
,,New York,11562,4893,6669,0,10641,4451,6190,0,904,432,472,0,0,0,0,0,2,0,2,0,16,10,6,0,0,0,0,0
,,North Carolina,3923,1564,2359,0,3777,1497,2280,0,136,61,75,0,1,1,0,0,0,0,0,0,9,5,4,0,0,0,0,0
,,North Dakota,565,223,342,0,545,213,332,0,19,9,10,0,0,0,0,0,1,0,1,0,0,0,0,0,1,1,0,0
,,Ohio,7057,2793,4264,0,6822,2697,4125,0,223,89,134,0,1,1,0,0,3,1,2,0,9,5,4,0,0,0,0,0
,,Oklahoma,1273,517,756,0,1240,499,741,0,30,16,14,0,0,0,0,0,0,0,0,0,3,2,1,0,0,0,0,0
,,Oregon,1782,696,1086,0,1728,667,1061,0,42,20,22,0,4,3,1,0,0,0,0,0,8,6,2,0,0,0,0,0
,,Pennsylvania,7141,2884,4257,0,6572,2634,3938,0,554,239,315,0,0,0,0,0,4,2,2,0,12,10,2,0,1,0,1,0
,,Puerto Rico,858,353,505,0,816,332,484,0,41,20,21,0,0,0,0,0,1,0,1,0,1,1,0,0,0,0,0,0
,,,,,,,,,,,,,,,,,,,,,,,,,,,,,,
,,,,,,,,,,,,,,,,,,,,,,,,,,,,,,
,,Rhode Island,727,281,446,0,686,259,427,0,37,19,18,0,0,0,0,0,0,0,0,0,4,3,1,0,0,0,0,0
,,South Carolina,1724,639,1085,0,1682,619,1063,0,38,16,22,0,0,0,0,0,0,0,0,0,4,4,0,0,0,0,0,0
,,South Dakota,554,230,324,0,536,220,316,0,18,10,8,0,0,0,0,0,1,1,0,0,0,0,0,0,0,0,0,0
,,State unassigned,4658,2244,2413,1,4335,2062,2272,1,286,157,129,0,6,4,2,0,4,1,3,0,28,20,8,0,1,1,0,0
,,Tennessee,2837,1082,1755,0,2770,1047,1723,0,63,33,30,0,0,0,0,0,1,0,1,0,4,2,2,0,0,0,0,0
,,Texas,10795,4136,6659,0,10504,4000,6504,0,262,122,140,0,2,1,1,0,1,0,1,0,25,13,12,0,2,0,2,0
,,Utah,1769,802,967,0,1700,770,930,0,63,28,35,0,1,1,0,0,0,0,0,0,5,3,2,0,0,0,0,0
,,Vermont,400,159,241,0,365,141,224,0,34,17,17,0,0,0,0,0,0,0,0,0,1,1,0,0,0,0,0,0
,,Virginia,5033,2108,2925,0,4734,1940,2794,0,285,158,127,0,1,0,1,0,1,0,1,0,10,9,1,0,3,1,2,0
,,Washington,2945,1114,1831,0,2868,1077,1791,0,67,34,33,0,3,0,3,0,0,0,0,0,7,3,4,0,0,0,0,0
,,West Virginia,826,309,517,0,745,269,476,0,78,39,39,0,0,0,0,0,2,1,1,0,2,1,1,0,0,0,0,0
,,Wisconsin,3981,1565,2416,0,3873,1520,2353,0,97,41,56,0,0,0,0,0,5,3,2,0,10,3,7,0,0,0,0,0
,,Wyoming,267,109,158,0,251,101,150,0,14,7,7,0,0,0,0,0,0,0,0,0,2,1,1,0,0,0,0,0
,< 1 Year,All Donor States of Residence,2,2,0,0,1,1,0,0,0,0,0,0,1,1,0,0,0,0,0,0,0,0,0,0,0,0,0,0
,,Ohio,1,1,0,0,0,0,0,0,0,0,0,0,1,1,0,0,0,0,0,0,0,0,0,0,0,0,0,0
,,Oklahoma,1,1,0,0,1,1,0,0,0,0,0,0,0,0,0,0,0,0,0,0,0,0,0,0,0,0,0,0
,1-5 Years,All Donor States of Residence,2,0,2,0,0,0,0,0,1,0,1,0,1,0,1,0,0,0,0,0,0,0,0,0,0,0,0,0
,,Pennsylvania,1,0,1,0,0,0,0,0,1,0,1,0,0,0,0,0,0,0,0,0,0,0,0,0,0,0,0,0
,,State unassigned,1,0,1,0,0,0,0,0,0,0,0,0,1,0,1,0,0,0,0,0,0,0,0,0,0,0,0,0
,6-10 Years,All Donor States of Residence,6,3,3,0,2,1,1,0,4,2,2,0,0,0,0,0,0,0,0,0,0,0,0,0,0,0,0,0
,,California,1,0,1,0,0,0,0,0,1,0,1,0,0,0,0,0,0,0,0,0,0,0,0,0,0,0,0,0
,,Connecticut,1,1,0,0,1,1,0,0,0,0,0,0,0,0,0,0,0,0,0,0,0,0,0,0,0,0,0,0
,,Florida,1,0,1,0,1,0,1,0,0,0,0,0,0,0,0,0,0,0,0,0,0,0,0,0,0,0,0,0
,,Maryland,1,1,0,0,0,0,0,0,1,1,0,0,0,0,0,0,0,0,0,0,0,0,0,0,0,0,0,0
,,Missouri,1,1,0,0,0,0,0,0,1,1,0,0,0,0,0,0,0,0,0,0,0,0,0,0,0,0,0,0
,,New York,1,0,1,0,0,0,0,0,1,0,1,0,0,0,0,0,0,0,0,0,0,0,0,0,0,0,0,0
,11-17 Years,All Donor States of Residence,65,28,37,0,45,20,25,0,20,8,12,0,0,0,0,0,0,0,0,0,0,0,0,0,0,0,0,0
,,California,4,3,1,0,3,2,1,0,1,1,0,0,0,0,0,0,0,0,0,0,0,0,0,0,0,0,0,0
,,District of Columbia,1,1,0,0,1,1,0,0,0,0,0,0,0,0,0,0,0,0,0,0,0,0,0,0,0,0,0,0
,,Georgia,1,1,0,0,0,0,0,0,1,1,0,0,0,0,0,0,0,0,0,0,0,0,0,0,0,0,0,0
,,Illinois,8,4,4,0,6,4,2,0,2,0,2,0,0,0,0,0,0,0,0,0,0,0,0,0,0,0,0,0
,,Indiana,3,0,3,0,2,0,2,0,1,0,1,0,0,0,0,0,0,0,0,0,0,0,0,0,0,0,0,0
,,Iowa,2,2,0,0,1,1,0,0,1,1,0,0,0,0,0,0,0,0,0,0,0,0,0,0,0,0,0,0
,,Kentucky,2,0,2,0,1,0,1,0,1,0,1,0,0,0,0,0,0,0,0,0,0,0,0,0,0,0,0,0
,,Maryland,4,1,3,0,2,0,2,0,2,1,1,0,0,0,0,0,0,0,0,0,0,0,0,0,0,0,0,0
,,Michigan,2,1,1,0,0,0,0,0,2,1,1,0,0,0,0,0,0,0,0,0,0,0,0,0,0,0,0,0
,,Minnesota,2,0,2,0,2,0,2,0,0,0,0,0,0,0,0,0,0,0,0,0,0,0,0,0,0,0,0,0
,,Missouri,4,1,3,0,4,1,3,0,0,0,0,0,0,0,0,0,0,0,0,0,0,0,0,0,0,0,0,0
,,New Jersey,2,1,1,0,1,1,0,0,1,0,1,0,0,0,0,0,0,0,0,0,0,0,0,0,0,0,0,0
,,New York,4,3,1,0,2,2,0,0,2,1,1,0,0,0,0,0,0,0,0,0,0,0,0,0,0,0,0,0
,,North Dakota,1,1,0,0,1,1,0,0,0,0,0,0,0,0,0,0,0,0,0,0,0,0,0,0,0,0,0,0
,,,,,,,,,,,,,,,,,,,,,,,,,,,,,,
,,,,,,,,,,,,,,,,,,,,,,,,,,,,,,
,,Ohio,4,3,1,0,4,3,1,0,0,0,0,0,0,0,0,0,0,0,0,0,0,0,0,0,0,0,0,0
,,Oklahoma,3,0,3,0,3,0,3,0,0,0,0,0,0,0,0,0,0,0,0,0,0,0,0,0,0,0,0,0
,,Pennsylvania,2,1,1,0,0,0,0,0,2,1,1,0,0,0,0,0,0,0,0,0,0,0,0,0,0,0,0,0
,,Puerto Rico,1,0,1,0,1,0,1,0,0,0,0,0,0,0,0,0,0,0,0,0,0,0,0,0,0,0,0,0
,,South Carolina,2,0,2,0,1,0,1,0,1,0,1,0,0,0,0,0,0,0,0,0,0,0,0,0,0,0,0,0
,,State unassigned,4,2,2,0,3,2,1,0,1,0,1,0,0,0,0,0,0,0,0,0,0,0,0,0,0,0,0,0
,,Tennessee,1,0,1,0,1,0,1,0,0,0,0,0,0,0,0,0,0,0,0,0,0,0,0,0,0,0,0,0
,,Texas,4,1,3,0,3,1,2,0,1,0,1,0,0,0,0,0,0,0,0,0,0,0,0,0,0,0,0,0
,,Virginia,2,2,0,0,1,1,0,0,1,1,0,0,0,0,0,0,0,0,0,0,0,0,0,0,0,0,0,0
,,Wisconsin,2,0,2,0,2,0,2,0,0,0,0,0,0,0,0,0,0,0,0,0,0,0,0,0,0,0,0,0
,18-34 Years,All Donor States of Residence,54646,25623,29023,0,50885,23691,27194,0,3545,1798,1747,0,17,8,9,0,23,11,12,0,165,110,55,0,27,13,14,0
,,Alabama,893,398,495,0,880,390,490,0,11,7,4,0,2,1,1,0,0,0,0,0,0,0,0,0,0,0,0,0
,,Alaska,108,46,62,0,101,42,59,0,7,4,3,0,0,0,0,0,0,0,0,0,0,0,0,0,0,0,0,0
,,Arizona,1103,501,602,0,1044,469,575,0,53,28,25,0,1,0,1,0,0,0,0,0,5,4,1,0,0,0,0,0
,,Arkansas,386,181,205,0,369,173,196,0,17,8,9,0,0,0,0,0,0,0,0,0,0,0,0,0,0,0,0,0
,,California,5948,2731,3217,0,5443,2475,2968,0,453,222,231,0,5,3,2,0,0,0,0,0,46,30,16,0,1,1,0,0
,,Colorado,828,425,403,0,728,366,362,0,95,55,40,0,0,0,0,0,0,0,0,0,4,3,1,0,1,1,0,0
,,Connecticut,555,258,297,0,505,230,275,0,50,28,22,0,0,0,0,0,0,0,0,0,0,0,0,0,0,0,0,0
,,Delaware,146,60,86,0,134,55,79,0,12,5,7,0,0,0,0,0,1,1,0,0,0,0,0,0,0,0,0,0
,,District of Columbia,221,110,111,0,207,106,101,0,14,4,10,0,0,0,0,0,0,0,0,0,0,0,0,0,0,0,0,0
,,Florida,1874,901,973,0,1804,866,938,0,65,34,31,0,1,1,0,0,0,0,0,0,4,0,4,0,0,0,0,0
,,Georgia,1335,576,759,0,1283,557,726,0,50,17,33,0,0,0,0,0,1,1,0,0,1,1,0,0,0,0,0,0
,,Hawaii,156,67,89,0,144,63,81,0,12,4,8,0,0,0,0,0,0,0,0,0,0,0,0,0,0,0,0,0
,,Idaho,214,96,118,0,202,90,112,0,11,6,5,0,1,0,1,0,0,0,0,0,0,0,0,0,0,0,0,0
,,Illinois,3259,1552,1707,0,3017,1433,1584,0,233,114,119,0,0,0,0,0,2,1,1,0,0,0,0,0,11,6,5,0
,,Indiana,1049,490,559,0,1022,476,546,0,23,12,11,0,0,0,0,0,0,0,0,0,1,1,0,0,3,1,2,0
,,Iowa,532,260,272,0,502,246,256,0,28,14,14,0,0,0,0,0,1,1,0,0,1,0,1,0,1,0,1,0
,,Kansas,350,150,200,0,335,142,193,0,13,6,7,0,0,0,0,0,0,0,0,0,2,2,0,0,0,0,0,0
,,Kentucky,615,278,337,0,593,265,328,0,21,12,9,0,0,0,0,0,1,1,0,0,0,0,0,0,0,0,0,0
,,Louisiana,778,353,425,0,749,337,412,0,27,15,12,0,0,0,0,0,0,0,0,0,2,1,1,0,0,0,0,0
,,Maine,194,97,97,0,163,79,84,0,27,15,12,0,0,0,0,0,0,0,0,0,4,3,1,0,0,0,0,0
,,Maryland,1471,670,801,0,1351,596,755,0,120,74,46,0,0,0,0,0,0,0,0,0,0,0,0,0,0,0,0,0
,,Massachusetts,1230,609,621,0,1102,535,567,0,113,65,48,0,0,0,0,0,1,0,1,0,13,9,4,0,1,0,1,0
,,Michigan,2168,1014,1154,0,2062,960,1102,0,105,54,51,0,0,0,0,0,0,0,0,0,1,0,1,0,0,0,0,0
,,Minnesota,1585,774,811,0,1475,721,754,0,99,47,52,0,1,0,1,0,8,2,6,0,5,4,1,0,3,2,1,0
,,Mississippi,352,164,188,0,334,157,177,0,14,6,8,0,1,0,1,0,0,0,0,0,3,1,2,0,0,0,0,0
,,Missouri,892,399,493,0,858,384,474,0,33,14,19,0,0,0,0,0,0,0,0,0,1,1,0,0,0,0,0,0
,,Montana,143,72,71,0,128,60,68,0,14,11,3,0,0,0,0,0,0,0,0,0,1,1,0,0,0,0,0,0
,,Nebraska,285,137,148,0,262,123,139,0,21,13,8,0,0,0,0,0,0,0,0,0,2,1,1,0,0,0,0,0
,,Nevada,344,160,184,0,319,146,173,0,20,9,11,0,0,0,0,0,0,0,0,0,5,5,0,0,0,0,0,0
,,New Hampshire,202,98,104,0,180,82,98,0,21,15,6,0,0,0,0,0,0,0,0,0,1,1,0,0,0,0,0,0
,,,,,,,,,,,,,,,,,,,,,,,,,,,,,,
,,,,,,,,,,,,,,,,,,,,,,,,,,,,,,
,,New Jersey,1617,796,821,0,1503,740,763,0,113,55,58,0,0,0,0,0,0,0,0,0,1,1,0,0,0,0,0,0
,,New Mexico,257,116,141,0,248,112,136,0,9,4,5,0,0,0,0,0,0,0,0,0,0,0,0,0,0,0,0,0
,,New York,3913,1942,1971,0,3467,1720,1747,0,439,217,222,0,0,0,0,0,0,0,0,0,7,5,2,0,0,0,0,0
,,North Carolina,1324,604,720,0,1256,573,683,0,68,31,37,0,0,0,0,0,0,0,0,0,0,0,0,0,0,0,0,0
,,North Dakota,174,89,85,0,167,83,84,0,7,6,1,0,0,0,0,0,0,0,0,0,0,0,0,0,0,0,0,0
,,Ohio,2301,1034,1267,0,2186,991,1195,0,113,42,71,0,0,0,0,0,1,0,1,0,1,1,0,0,0,0,0,0
,,Oklahoma,387,184,203,0,370,173,197,0,14,9,5,0,0,0,0,0,0,0,0,0,3,2,1,0,0,0,0,0
,,Oregon,505,231,274,0,478,218,260,0,23,10,13,0,2,2,0,0,0,0,0,0,2,1,1,0,0,0,0,0
,,Pennsylvania,2209,1018,1191,0,1935,884,1051,0,266,128,138,0,0,0,0,0,3,2,1,0,5,5,0,0,1,0,1,0
,,Puerto Rico,366,180,186,0,339,167,172,0,27,13,14,0,0,0,0,0,0,0,0,0,0,0,0,0,0,0,0,0
,,Rhode Island,225,105,120,0,205,94,111,0,17,9,8,0,0,0,0,0,0,0,0,0,3,2,1,0,0,0,0,0
,,South Carolina,580,231,349,0,562,222,340,0,16,7,9,0,0,0,0,0,0,0,0,0,2,2,0,0,0,0,0,0
,,South Dakota,149,67,82,0,140,62,78,0,9,5,4,0,0,0,0,0,0,0,0,0,0,0,0,0,0,0,0,0
,,State unassigned,1842,1067,775,0,1645,948,697,0,181,105,76,0,1,1,0,0,0,0,0,0,14,12,2,0,1,1,0,0
,,Tennessee,1075,462,613,0,1040,439,601,0,32,21,11,0,0,0,0,0,0,0,0,0,3,2,1,0,0,0,0,0
,,Texas,3860,1675,2185,0,3715,1608,2107,0,133,63,70,0,1,0,1,0,1,0,1,0,10,4,6,0,1,0,1,0
,,Utah,684,353,331,0,645,334,311,0,38,18,20,0,0,0,0,0,0,0,0,0,1,1,0,0,0,0,0,0
,,Vermont,117,61,56,0,102,51,51,0,15,10,5,0,0,0,0,0,0,0,0,0,0,0,0,0,0,0,0,0
,,Virginia,1532,736,796,0,1409,672,737,0,120,63,57,0,0,0,0,0,1,0,1,0,0,0,0,0,3,1,2,0
,,Washington,829,368,461,0,786,347,439,0,37,19,18,0,1,0,1,0,0,0,0,0,5,2,3,0,0,0,0,0
,,West Virginia,273,121,152,0,231,96,135,0,40,24,16,0,0,0,0,0,0,0,0,0,2,1,1,0,0,0,0,0
,,Wisconsin,1127,516,611,0,1084,498,586,0,39,17,22,0,0,0,0,0,2,2,0,0,3,0,3,0,0,0,0,0
,,Wyoming,84,40,44,0,76,35,41,0,7,4,3,0,0,0,0,0,0,0,0,0,1,1,0,0,0,0,0,0
,35-49 Years,All Donor States of Residence,71426,27193,44233,0,68367,25774,42593,0,2774,1254,1520,0,18,9,9,0,33,10,23,0,251,150,101,0,9,5,4,0
,,Alabama,1142,412,730,0,1132,405,727,0,7,5,2,0,0,0,0,0,0,0,0,0,3,2,1,0,0,0,0,0
,,Alaska,176,69,107,0,173,68,105,0,1,0,1,0,1,0,1,0,0,0,0,0,1,1,0,0,0,0,0,0
,,Arizona,1346,512,834,0,1264,468,796,0,62,30,32,0,1,1,0,0,0,0,0,0,19,13,6,0,0,0,0,0
,,Arkansas,461,162,299,0,450,157,293,0,6,3,3,0,0,0,0,0,1,0,1,0,4,2,2,0,0,0,0,0
,,California,7194,2732,4462,0,6803,2548,4255,0,323,145,178,0,3,0,3,0,1,0,1,0,64,39,25,0,0,0,0,0
,,Colorado,1262,511,751,0,1190,480,710,0,71,30,41,0,0,0,0,0,0,0,0,0,1,1,0,0,0,0,0,0
,,Connecticut,860,320,540,0,811,300,511,0,48,19,29,0,0,0,0,0,1,1,0,0,1,1,0,0,0,0,0,0
,,Delaware,223,86,137,0,210,79,131,0,13,7,6,0,0,0,0,0,0,0,0,0,0,0,0,0,0,0,0,0
,,District of Columbia,166,70,96,0,162,67,95,0,4,3,1,0,0,0,0,0,0,0,0,0,0,0,0,0,0,0,0,0
,,Florida,2636,1027,1609,0,2577,1003,1574,0,47,20,27,0,0,0,0,0,0,0,0,0,12,4,8,0,0,0,0,0
,,Georgia,1839,650,1189,0,1803,636,1167,0,32,12,20,0,1,1,0,0,0,0,0,0,3,1,2,0,0,0,0,0
,,Hawaii,194,87,107,0,191,85,106,0,3,2,1,0,0,0,0,0,0,0,0,0,0,0,0,0,0,0,0,0
,,Idaho,351,117,234,0,338,112,226,0,13,5,8,0,0,0,0,0,0,0,0,0,0,0,0,0,0,0,0,0
,,Illinois,3384,1331,2053,0,3210,1253,1957,0,163,71,92,0,0,0,0,0,5,1,4,0,5,4,1,0,6,3,3,0
,,Indiana,1467,542,925,0,1430,523,907,0,30,16,14,0,0,0,0,0,0,0,0,0,7,3,4,0,0,0,0,0
,,Iowa,855,319,536,0,834,308,526,0,17,8,9,0,0,0,0,0,1,0,1,0,4,3,1,0,0,0,0,0
,,Kansas,478,189,289,0,462,177,285,0,13,9,4,0,0,0,0,0,0,0,0,0,3,3,0,0,0,0,0,0
,,,,,,,,,,,,,,,,,,,,,,,,,,,,,,
,,,,,,,,,,,,,,,,,,,,,,,,,,,,,,
,,Kentucky,870,313,557,0,851,304,547,0,18,9,9,0,0,0,0,0,1,0,1,0,1,0,1,0,0,0,0,0
,,Louisiana,770,294,476,0,761,288,473,0,8,5,3,0,0,0,0,0,0,0,0,0,0,0,0,0,1,1,0,0
,,Maine,370,133,237,0,343,121,222,0,24,12,12,0,0,0,0,0,0,0,0,0,3,0,3,0,0,0,0,0
,,Maryland,1836,659,1177,0,1742,609,1133,0,91,49,42,0,0,0,0,0,1,0,1,0,3,1,2,0,0,0,0,0
,,Massachusetts,1844,717,1127,0,1693,650,1043,0,136,61,75,0,0,0,0,0,0,0,0,0,15,6,9,0,0,0,0,0
,,Michigan,2842,1063,1779,0,2752,1027,1725,0,86,34,52,0,1,0,1,0,0,0,0,0,3,2,1,0,0,0,0,0
,,Minnesota,2208,894,1314,0,2108,846,1262,0,93,45,48,0,1,0,1,0,10,5,5,0,5,3,2,0,0,0,0,0
,,Mississippi,470,176,294,0,456,174,282,0,14,2,12,0,0,0,0,0,0,0,0,0,0,0,0,0,0,0,0,0
,,Missouri,1057,404,653,0,1030,391,639,0,24,11,13,0,0,0,0,0,0,0,0,0,3,2,1,0,0,0,0,0
,,Montana,271,102,169,0,262,98,164,0,8,3,5,0,1,1,0,0,0,0,0,0,0,0,0,0,0,0,0,0
,,Nebraska,463,181,282,0,446,173,273,0,14,5,9,0,0,0,0,0,0,0,0,0,3,3,0,0,0,0,0,0
,,Nevada,414,182,232,0,397,173,224,0,15,8,7,0,0,0,0,0,0,0,0,0,2,1,1,0,0,0,0,0
,,New Hampshire,410,169,241,0,380,150,230,0,27,16,11,0,0,0,0,0,0,0,0,0,3,3,0,0,0,0,0,0
,,New Jersey,2374,894,1480,0,2295,863,1432,0,76,29,47,0,0,0,0,0,0,0,0,0,3,2,1,0,0,0,0,0
,,New Mexico,392,146,246,0,374,137,237,0,18,9,9,0,0,0,0,0,0,0,0,0,0,0,0,0,0,0,0,0
,,New York,4727,1897,2830,0,4366,1732,2634,0,351,160,191,0,0,0,0,0,1,0,1,0,9,5,4,0,0,0,0,0
,,North Carolina,1719,631,1088,0,1655,605,1050,0,58,23,35,0,1,1,0,0,0,0,0,0,5,2,3,0,0,0,0,0
,,North Dakota,249,89,160,0,240,85,155,0,8,3,5,0,0,0,0,0,1,0,1,0,0,0,0,0,1,1,0,0
,,Ohio,3159,1196,1963,0,3065,1154,1911,0,85,37,48,0,0,0,0,0,2,1,1,0,8,4,4,0,0,0,0,0
,,Oklahoma,573,209,364,0,560,204,356,0,13,5,8,0,0,0,0,0,0,0,0,0,0,0,0,0,0,0,0,0
,,Oregon,781,284,497,0,761,272,489,0,16,9,7,0,0,0,0,0,0,0,0,0,4,3,1,0,0,0,0,0
,,Pennsylvania,3236,1253,1983,0,3012,1165,1847,0,220,85,135,0,0,0,0,0,1,0,1,0,4,3,1,0,0,0,0,0
,,Puerto Rico,352,130,222,0,338,122,216,0,13,7,6,0,0,0,0,0,0,0,0,0,1,1,0,0,0,0,0,0
,,Rhode Island,312,117,195,0,296,108,188,0,15,8,7,0,0,0,0,0,0,0,0,0,1,1,0,0,0,0,0,0
,,South Carolina,791,274,517,0,770,264,506,0,19,8,11,0,0,0,0,0,0,0,0,0,2,2,0,0,0,0,0,0
,,South Dakota,245,105,140,0,238,100,138,0,7,5,2,0,0,0,0,0,1,1,0,0,0,0,0,0,0,0,0,0
,,State unassigned,1971,866,1105,0,1868,812,1056,0,87,44,43,0,4,3,1,0,3,1,2,0,11,7,4,0,0,0,0,0
,,Tennessee,1206,434,772,0,1181,424,757,0,25,10,15,0,0,0,0,0,1,0,1,0,0,0,0,0,0,0,0,0
,,Texas,4633,1661,2972,0,4521,1613,2908,0,98,39,59,0,1,1,0,0,0,0,0,0,12,8,4,0,1,0,1,0
,,Utah,762,315,447,0,739,302,437,0,18,10,8,0,1,1,0,0,0,0,0,0,4,2,2,0,0,0,0,0
,,Vermont,180,61,119,0,166,56,110,0,13,4,9,0,0,0,0,0,0,0,0,0,1,1,0,0,0,0,0,0
,,Virginia,2277,899,1378,0,2147,823,1324,0,121,68,53,0,0,0,0,0,0,0,0,0,9,8,1,0,0,0,0,0
,,Washington,1287,449,838,0,1261,437,824,0,22,11,11,0,2,0,2,0,0,0,0,0,2,1,1,0,0,0,0,0
,,West Virginia,377,131,246,0,345,117,228,0,31,14,17,0,0,0,0,0,1,0,1,0,0,0,0,0,0,0,0,0
,,Wisconsin,1846,680,1166,0,1794,659,1135,0,46,19,27,0,0,0,0,0,1,0,1,0,6,2,4,0,0,0,0,0
,,Wyoming,118,49,69,0,114,47,67,0,3,2,1,0,0,0,0,0,0,0,0,0,1,0,1,0,0,0,0,0
,50-64 Years,All Donor States of Residence,35926,12872,23054,0,35011,12444,22567,0,835,379,456,0,6,2,4,0,16,5,11,0,60,40,20,0,8,5,3,0
,,Alabama,514,206,308,0,512,205,307,0,1,1,0,0,0,0,0,0,1,0,1,0,0,0,0,0,0,0,0,0
,,Alaska,97,43,54,0,96,43,53,0,1,0,1,0,0,0,0,0,0,0,0,0,0,0,0,0,0,0,0,0
,,Arizona,736,250,486,0,715,242,473,0,20,7,13,0,0,0,0,0,0,0,0,0,1,1,0,0,0,0,0,0
,,Arkansas,209,71,138,0,205,69,136,0,2,1,1,0,0,0,0,0,0,0,0,0,2,1,1,0,0,0,0,0
,,,,,,,,,,,,,,,,,,,,,,,,,,,,,,
,,,,,,,,,,,,,,,,,,,,,,,,,,,,,,
,,California,3557,1335,2222,0,3440,1271,2169,0,96,48,48,0,1,1,0,0,0,0,0,0,19,15,4,0,1,0,1,0
,,Colorado,672,259,413,0,646,252,394,0,26,7,19,0,0,0,0,0,0,0,0,0,0,0,0,0,0,0,0,0
,,Connecticut,618,238,380,0,598,231,367,0,20,7,13,0,0,0,0,0,0,0,0,0,0,0,0,0,0,0,0,0
,,Delaware,93,27,66,0,92,27,65,0,1,0,1,0,0,0,0,0,0,0,0,0,0,0,0,0,0,0,0,0
,,District of Columbia,80,33,47,0,77,33,44,0,2,0,2,0,0,0,0,0,0,0,0,0,1,0,1,0,0,0,0,0
,,Florida,1543,501,1042,0,1521,491,1030,0,18,8,10,0,0,0,0,0,2,1,1,0,3,1,2,0,0,0,0,0
,,Georgia,840,277,563,0,829,273,556,0,10,4,6,0,0,0,0,0,1,0,1,0,0,0,0,0,0,0,0,0
,,Hawaii,148,59,89,0,145,58,87,0,3,1,2,0,0,0,0,0,0,0,0,0,0,0,0,0,0,0,0,0
,,Idaho,170,73,97,0,167,71,96,0,2,2,0,0,1,0,1,0,0,0,0,0,0,0,0,0,0,0,0,0
,,Illinois,1608,597,1011,0,1563,572,991,0,40,21,19,0,0,0,0,0,1,1,0,0,1,0,1,0,3,3,0,0
,,Indiana,609,193,416,0,596,190,406,0,12,3,9,0,0,0,0,0,1,0,1,0,0,0,0,0,0,0,0,0
,,Iowa,445,164,281,0,440,162,278,0,5,2,3,0,0,0,0,0,0,0,0,0,0,0,0,0,0,0,0,0
,,Kansas,245,83,162,0,242,81,161,0,3,2,1,0,0,0,0,0,1,0,1,0,0,0,0,0,0,0,0,0
,,Kentucky,321,104,217,0,321,104,217,0,0,0,0,0,0,0,0,0,0,0,0,0,0,0,0,0,0,0,0,0
,,Louisiana,339,125,214,0,334,123,211,0,4,2,2,0,0,0,0,0,0,0,0,0,0,0,0,0,1,0,1,0
,,Maine,241,95,146,0,224,84,140,0,14,9,5,0,0,0,0,0,1,0,1,0,3,2,1,0,0,0,0,0
,,Maryland,950,348,602,0,918,329,589,0,32,19,13,0,0,0,0,0,0,0,0,0,0,0,0,0,0,0,0,0
,,Massachusetts,1066,381,685,0,1008,352,656,0,52,23,29,0,0,0,0,0,0,0,0,0,6,6,0,0,0,0,0,0
,,Michigan,1474,526,948,0,1449,511,938,0,21,13,8,0,0,0,0,0,0,0,0,0,3,1,2,0,1,1,0,0
,,Minnesota,1172,441,731,0,1138,429,709,0,31,12,19,0,1,0,1,0,2,1,1,0,1,0,1,0,1,0,1,0
,,Mississippi,179,47,132,0,175,47,128,0,4,0,4,0,0,0,0,0,0,0,0,0,0,0,0,0,0,0,0,0
,,Missouri,503,172,331,0,500,169,331,0,3,3,0,0,0,0,0,0,0,0,0,0,0,0,0,0,0,0,0,0
,,Montana,136,41,95,0,135,41,94,0,1,0,1,0,0,0,0,0,0,0,0,0,0,0,0,0,0,0,0,0
,,Nebraska,270,99,171,0,265,97,168,0,4,1,3,0,0,0,0,0,0,0,0,0,1,1,0,0,0,0,0,0
,,Nevada,205,78,127,0,200,75,125,0,4,2,2,0,0,0,0,0,0,0,0,0,1,1,0,0,0,0,0,0
,,New Hampshire,260,96,164,0,248,92,156,0,11,4,7,0,0,0,0,0,0,0,0,0,1,0,1,0,0,0,0,0
,,New Jersey,1401,444,957,0,1369,429,940,0,32,15,17,0,0,0,0,0,0,0,0,0,0,0,0,0,0,0,0,0
,,New Mexico,200,92,108,0,194,90,104,0,5,1,4,0,0,0,0,0,0,0,0,0,0,0,0,0,1,1,0,0
,,New York,2654,957,1697,0,2549,907,1642,0,105,50,55,0,0,0,0,0,1,0,1,0,0,0,0,0,0,0,0,0
,,North Carolina,807,307,500,0,793,297,496,0,10,7,3,0,0,0,0,0,0,0,0,0,4,3,1,0,0,0,0,0
,,North Dakota,130,40,90,0,126,40,86,0,4,0,4,0,0,0,0,0,0,0,0,0,0,0,0,0,0,0,0,0
,,Ohio,1494,511,983,0,1469,501,968,0,25,10,15,0,0,0,0,0,0,0,0,0,0,0,0,0,0,0,0,0
,,Oklahoma,290,113,177,0,287,111,176,0,3,2,1,0,0,0,0,0,0,0,0,0,0,0,0,0,0,0,0,0
,,Oregon,446,166,280,0,439,162,277,0,3,1,2,0,2,1,1,0,0,0,0,0,2,2,0,0,0,0,0,0
,,Pennsylvania,1577,569,1008,0,1509,542,967,0,65,25,40,0,0,0,0,0,0,0,0,0,3,2,1,0,0,0,0,0
,,Puerto Rico,131,41,90,0,130,41,89,0,1,0,1,0,0,0,0,0,1,0,1,0,0,0,0,0,0,0,0,0
,,Rhode Island,181,56,125,0,176,54,122,0,5,2,3,0,0,0,0,0,0,0,0,0,0,0,0,0,0,0,0,0
,,South Carolina,321,119,202,0,319,118,201,0,2,1,1,0,0,0,0,0,0,0,0,0,0,0,0,0,0,0,0,0
,,South Dakota,148,53,95,0,146,53,93,0,2,0,2,0,0,0,0,0,0,0,0,0,0,0,0,0,0,0,0,0
,,State unassigned,763,280,483,0,745,272,473,0,15,7,8,0,0,0,0,0,1,0,1,0,2,1,1,0,0,0,0,0
,,Tennessee,520,176,344,0,513,174,339,0,6,2,4,0,0,0,0,0,0,0,0,0,1,0,1,0,0,0,0,0
,,,,,,,,,,,,,,,,,,,,,,,,,,,,,,
,,,,,,,,,,,,,,,,,,,,,,,,,,,,,,
,,Texas,2132,736,1396,0,2101,717,1384,0,28,18,10,0,0,0,0,0,0,0,0,0,3,1,2,0,0,0,0,0
,,Utah,307,126,181,0,300,126,174,0,7,0,7,0,0,0,0,0,0,0,0,0,0,0,0,0,0,0,0,0
,,Vermont,99,36,63,0,93,33,60,0,6,3,3,0,0,0,0,0,0,0,0,0,0,0,0,0,0,0,0,0
,,Virginia,1132,425,707,0,1092,402,690,0,38,22,16,0,1,0,1,0,0,0,0,0,1,1,0,0,0,0,0,0
,,Washington,757,266,491,0,749,262,487,0,8,4,4,0,0,0,0,0,0,0,0,0,0,0,0,0,0,0,0,0
,,West Virginia,158,49,109,0,152,48,104,0,6,1,5,0,0,0,0,0,1,1,0,0,0,0,0,0,0,0,0,0
,,Wisconsin,918,329,589,0,905,323,582,0,12,5,7,0,0,0,0,0,2,1,1,0,1,1,0,0,0,0,0,0
,,Wyoming,60,19,41,0,56,18,38,0,4,1,3,0,0,0,0,0,0,0,0,0,0,0,0,0,0,0,0,0
,65 +,All Donor States of Residence,2980,1156,1824,0,2959,1140,1819,0,19,15,4,0,0,0,0,0,0,0,0,0,2,1,1,0,0,0,0,0
,,Alabama,38,17,21,0,38,17,21,0,0,0,0,0,0,0,0,0,0,0,0,0,0,0,0,0,0,0,0,0
,,Alaska,5,3,2,0,5,3,2,0,0,0,0,0,0,0,0,0,0,0,0,0,0,0,0,0,0,0,0,0
,,Arizona,51,14,37,0,50,14,36,0,1,0,1,0,0,0,0,0,0,0,0,0,0,0,0,0,0,0,0,0
,,Arkansas,9,3,6,0,9,3,6,0,0,0,0,0,0,0,0,0,0,0,0,0,0,0,0,0,0,0,0,0
,,California,337,133,204,0,336,132,204,0,1,1,0,0,0,0,0,0,0,0,0,0,0,0,0,0,0,0,0,0
,,Colorado,37,16,21,0,37,16,21,0,0,0,0,0,0,0,0,0,0,0,0,0,0,0,0,0,0,0,0,0
,,Connecticut,61,22,39,0,60,21,39,0,0,0,0,0,0,0,0,0,0,0,0,0,1,1,0,0,0,0,0,0
,,Delaware,10,3,7,0,10,3,7,0,0,0,0,0,0,0,0,0,0,0,0,0,0,0,0,0,0,0,0,0
,,District of Columbia,6,5,1,0,6,5,1,0,0,0,0,0,0,0,0,0,0,0,0,0,0,0,0,0,0,0,0,0
,,Florida,153,53,100,0,152,52,100,0,1,1,0,0,0,0,0,0,0,0,0,0,0,0,0,0,0,0,0,0
,,Georgia,56,20,36,0,56,20,36,0,0,0,0,0,0,0,0,0,0,0,0,0,0,0,0,0,0,0,0,0
,,Hawaii,14,4,10,0,14,4,10,0,0,0,0,0,0,0,0,0,0,0,0,0,0,0,0,0,0,0,0,0
,,Idaho,11,6,5,0,11,6,5,0,0,0,0,0,0,0,0,0,0,0,0,0,0,0,0,0,0,0,0,0
,,Illinois,102,42,60,0,102,42,60,0,0,0,0,0,0,0,0,0,0,0,0,0,0,0,0,0,0,0,0,0
,,Indiana,31,13,18,0,31,13,18,0,0,0,0,0,0,0,0,0,0,0,0,0,0,0,0,0,0,0,0,0
,,Iowa,42,23,19,0,42,23,19,0,0,0,0,0,0,0,0,0,0,0,0,0,0,0,0,0,0,0,0,0
,,Kansas,15,9,6,0,14,8,6,0,1,1,0,0,0,0,0,0,0,0,0,0,0,0,0,0,0,0,0,0
,,Kentucky,21,11,10,0,21,11,10,0,0,0,0,0,0,0,0,0,0,0,0,0,0,0,0,0,0,0,0,0
,,Louisiana,19,9,10,0,19,9,10,0,0,0,0,0,0,0,0,0,0,0,0,0,0,0,0,0,0,0,0,0
,,Maine,31,16,15,0,31,16,15,0,0,0,0,0,0,0,0,0,0,0,0,0,0,0,0,0,0,0,0,0
,,Maryland,108,34,74,0,107,33,74,0,1,1,0,0,0,0,0,0,0,0,0,0,0,0,0,0,0,0,0,0
,,Massachusetts,90,36,54,0,89,35,54,0,1,1,0,0,0,0,0,0,0,0,0,0,0,0,0,0,0,0,0,0
,,Michigan,103,42,61,0,103,42,61,0,0,0,0,0,0,0,0,0,0,0,0,0,0,0,0,0,0,0,0,0
,,Minnesota,111,38,73,0,109,36,73,0,2,2,0,0,0,0,0,0,0,0,0,0,0,0,0,0,0,0,0,0
,,Mississippi,13,6,7,0,13,6,7,0,0,0,0,0,0,0,0,0,0,0,0,0,0,0,0,0,0,0,0,0
,,Missouri,47,19,28,0,47,19,28,0,0,0,0,0,0,0,0,0,0,0,0,0,0,0,0,0,0,0,0,0
,,Montana,10,3,7,0,10,3,7,0,0,0,0,0,0,0,0,0,0,0,0,0,0,0,0,0,0,0,0,0
,,Nebraska,11,6,5,0,10,6,4,0,1,0,1,0,0,0,0,0,0,0,0,0,0,0,0,0,0,0,0,0
,,Nevada,17,6,11,0,17,6,11,0,0,0,0,0,0,0,0,0,0,0,0,0,0,0,0,0,0,0,0,0
,,New Hampshire,22,10,12,0,22,10,12,0,0,0,0,0,0,0,0,0,0,0,0,0,0,0,0,0,0,0,0,0
,,New Jersey,138,40,98,0,136,39,97,0,2,1,1,0,0,0,0,0,0,0,0,0,0,0,0,0,0,0,0,0
,,New Mexico,20,6,14,0,20,6,14,0,0,0,0,0,0,0,0,0,0,0,0,0,0,0,0,0,0,0,0,0
,,,,,,,,,,,,,,,,,,,,,,,,,,,,,,
,,,,,,,,,,,,,,,,,,,,,,,,,,,,,,
,,New York,261,94,167,0,257,90,167,0,4,4,0,0,0,0,0,0,0,0,0,0,0,0,0,0,0,0,0,0
,,North Carolina,73,22,51,0,73,22,51,0,0,0,0,0,0,0,0,0,0,0,0,0,0,0,0,0,0,0,0,0
,,North Dakota,11,4,7,0,11,4,7,0,0,0,0,0,0,0,0,0,0,0,0,0,0,0,0,0,0,0,0,0
,,Ohio,98,48,50,0,98,48,50,0,0,0,0,0,0,0,0,0,0,0,0,0,0,0,0,0,0,0,0,0
,,Oklahoma,19,10,9,0,19,10,9,0,0,0,0,0,0,0,0,0,0,0,0,0,0,0,0,0,0,0,0,0
,,Oregon,50,15,35,0,50,15,35,0,0,0,0,0,0,0,0,0,0,0,0,0,0,0,0,0,0,0,0,0
,,Pennsylvania,116,43,73,0,116,43,73,0,0,0,0,0,0,0,0,0,0,0,0,0,0,0,0,0,0,0,0,0
,,Puerto Rico,8,2,6,0,8,2,6,0,0,0,0,0,0,0,0,0,0,0,0,0,0,0,0,0,0,0,0,0
,,Rhode Island,9,3,6,0,9,3,6,0,0,0,0,0,0,0,0,0,0,0,0,0,0,0,0,0,0,0,0,0
,,South Carolina,30,15,15,0,30,15,15,0,0,0,0,0,0,0,0,0,0,0,0,0,0,0,0,0,0,0,0,0
,,South Dakota,12,5,7,0,12,5,7,0,0,0,0,0,0,0,0,0,0,0,0,0,0,0,0,0,0,0,0,0
,,State unassigned,66,24,42,0,65,24,41,0,0,0,0,0,0,0,0,0,0,0,0,0,1,0,1,0,0,0,0,0
,,Tennessee,35,10,25,0,35,10,25,0,0,0,0,0,0,0,0,0,0,0,0,0,0,0,0,0,0,0,0,0
,,Texas,164,61,103,0,162,59,103,0,2,2,0,0,0,0,0,0,0,0,0,0,0,0,0,0,0,0,0,0
,,Utah,16,8,8,0,16,8,8,0,0,0,0,0,0,0,0,0,0,0,0,0,0,0,0,0,0,0,0,0
,,Vermont,4,1,3,0,4,1,3,0,0,0,0,0,0,0,0,0,0,0,0,0,0,0,0,0,0,0,0,0
,,Virginia,86,43,43,0,85,42,43,0,1,1,0,0,0,0,0,0,0,0,0,0,0,0,0,0,0,0,0,0
,,Washington,72,31,41,0,72,31,41,0,0,0,0,0,0,0,0,0,0,0,0,0,0,0,0,0,0,0,0,0
,,West Virginia,18,8,10,0,17,8,9,0,1,0,1,0,0,0,0,0,0,0,0,0,0,0,0,0,0,0,0,0
,,Wisconsin,88,40,48,0,88,40,48,0,0,0,0,0,0,0,0,0,0,0,0,0,0,0,0,0,0,0,0,0
,,Wyoming,5,1,4,0,5,1,4,0,0,0,0,0,0,0,0,0,0,0,0,0,0,0,0,0,0,0,0,0
,Unknown,All Donor States of Residence,23,12,10,1,11,6,4,1,12,6,6,0,0,0,0,0,0,0,0,0,0,0,0,0,0,0,0,0
,,Alabama,1,0,1,0,0,0,0,0,1,0,1,0,0,0,0,0,0,0,0,0,0,0,0,0,0,0,0,0
,,California,1,0,1,0,0,0,0,0,1,0,1,0,0,0,0,0,0,0,0,0,0,0,0,0,0,0,0,0
,,Maryland,1,1,0,0,0,0,0,0,1,1,0,0,0,0,0,0,0,0,0,0,0,0,0,0,0,0,0,0
,,Missouri,1,1,0,0,0,0,0,0,1,1,0,0,0,0,0,0,0,0,0,0,0,0,0,0,0,0,0,0
,,New York,2,0,2,0,0,0,0,0,2,0,2,0,0,0,0,0,0,0,0,0,0,0,0,0,0,0,0,0
,,State unassigned,11,5,5,1,9,4,4,1,2,1,1,0,0,0,0,0,0,0,0,0,0,0,0,0,0,0,0,0
,,Texas,2,2,0,0,2,2,0,0,0,0,0,0,0,0,0,0,0,0,0,0,0,0,0,0,0,0,0,0
,,Virginia,4,3,1,0,0,0,0,0,4,3,1,0,0,0,0,0,0,0,0,0,0,0,0,0,0,0,0,0
