Donor Type,Donor State of Residence,Donor Ethnicity,All Donors - All Genders,All Donors - Male,All Donors - Female,All Donors - Unknown,Kidney - All Genders,Kidney - Male,Kidney - Female,Kidney - Unknown,Liver - All Genders,Liver - Male,Liver - Female,Liver - Unknown,Heart - All Genders,Heart - Male,Heart - Female,Heart - Unknown,Pancreas - All Genders,Pancreas - Male,Pancreas - Female,Pancreas - Unknown,Lung - All Genders,Lung - Male,Lung - Female,Lung - Unknown,Intestine - All Genders,Intestine - Male,Intestine - Female,Intestine - Unknown
All Donor Types,All Donor States of Residence,All Ethnicities,387089,199626,187462,1,360646,184762,175883,1,187160,111108,76052,0,78109,53411,24698,0,46574,30911,15663,0,39849,24061,15788,0,3430,2011,1419,0
,,White,273107,138396,134711,0,255889,128862,127027,0,130749,75958,54791,0,53987,36019,17968,0,33376,21328,12048,0,26230,15187,11043,0,2171,1235,936,0
,,Black,50384,27165,23219,0,45451,24308,21143,0,27195,16586,10609,0,10963,7854,3109,0,6477,4775,1702,0,6678,4389,2289,0,664,423,241,0
,,Hispanic,47857,26515,21342,0,44589,24610,19979,0,22462,14788,7674,0,10972,8102,2870,0,5393,3948,1445,0,5409,3667,1742,0,485,295,190,0
,,Unknown,328,173,154,1,309,162,146,1,169,102,67,0,83,55,28,0,52,31,21,0,21,11,10,0,4,3,1,0
,,Asian,9780,4544,5236,0,9150,4203,4947,0,4037,2142,1895,0,1153,704,449,0,710,419,291,0,983,469,514,0,55,24,31,0
,,American Indian/Alaska Native,1736,825,911,0,1661,788,873,0,677,407,270,0,345,235,110,0,198,143,55,0,162,106,56,0,13,7,6,0
,,Pacific Islander,1248,630,618,0,1188,602,586,0,445,255,190,0,121,76,45,0,90,64,26,0,87,47,40,0,4,2,2,0
,,Multiracial,2649,1378,1271,0,2409,1227,1182,0,1426,870,556,0,485,366,119,0,278,203,75,0,279,185,94,0,34,22,12,0
,Alabama,All Ethnicities,6338,3297,3041,0,6014,3096,2918,0,3111,1880,1231,0,1193,854,339,0,603,433,170,0,572,379,193,0,36,22,14,0
,,White,4714,2405,2309,0,4510,2278,2232,0,2290,1357,933,0,881,614,267,0,441,301,140,0,401,255,146,0,24,14,10,0
,,Black,1494,815,679,0,1379,744,635,0,760,476,284,0,275,211,64,0,150,122,28,0,158,114,44,0,9,6,3,0
,,Hispanic,72,47,25,0,70,45,25,0,35,31,4,0,25,22,3,0,7,7,0,0,8,7,1,0,2,2,0,0
,,Unknown,2,1,1,0,2,1,1,0,1,0,1,0,0,0,0,0,0,0,0,0,0,0,0,0,0,0,0,0
,,Asian,40,21,19,0,38,20,18,0,17,11,6,0,7,4,3,0,4,2,2,0,3,2,1,0,1,0,1,0
,,American Indian/Alaska Native,5,3,2,0,5,3,2,0,1,1,0,0,1,1,0,0,1,1,0,0,0,0,0,0,0,0,0,0
,,Pacific Islander,1,0,1,0,0,0,0,0,1,0,1,0,1,0,1,0,0,0,0,0,0,0,0,0,0,0,0,0
,,Multiracial,10,5,5,0,10,5,5,0,6,4,2,0,3,2,1,0,0,0,0,0,2,1,1,0,0,0,0,0
,Alaska,All Ethnicities,1008,556,452,0,979,537,442,0,499,321,178,0,210,165,45,0,150,121,29,0,129,86,43,0,1,1,0,0
,,White,770,422,348,0,745,406,339,0,364,231,133,0,155,119,36,0,107,85,22,0,95,63,32,0,0,0,0,0
,,Black,40,22,18,0,39,21,18,0,21,15,6,0,7,4,3,0,8,6,2,0,6,4,2,0,0,0,0,0
,,Hispanic,21,14,7,0,20,13,7,0,11,8,3,0,7,6,1,0,2,1,1,0,2,1,1,0,0,0,0,0
,,Asian,25,13,12,0,24,12,12,0,17,10,7,0,7,6,1,0,3,3,0,0,7,3,4,0,0,0,0,0
,,American Indian/Alaska Native,135,77,58,0,134,77,57,0,78,52,26,0,32,28,4,0,29,25,4,0,17,14,3,0,1,1,0,0
,,Pacific Islander,10,4,6,0,10,4,6,0,5,3,2,0,0,0,0,0,0,0,0,0,2,1,1,0,0,0,0,0
,,Multiracial,7,4,3,0,7,4,3,0,3,2,1,0,2,2,0,0,1,1,0,0,0,0,0,0,0,0,0,0
,Arizona,All Ethnicities,7007,3627,3380,0,6666,3438,3228,0,3242,2018,1224,0,1341,955,386,0,687,474,213,0,754,483,271,0,45,34,11,0
,,White,4802,2427,2375,0,4557,2297,2260,0,2222,1339,883,0,886,617,269,0,451,303,148,0,492,303,189,0,23,18,5,0
,,Black,331,184,147,0,304,167,137,0,177,110,67,0,66,45,21,0,30,17,13,0,43,26,17,0,1,1,0,0
,,Hispanic,1516,859,657,0,1453,819,634,0,730,501,229,0,331,254,77,0,184,138,46,0,184,135,49,0,19,13,6,0
,,Unknown,2,2,0,0,2,2,0,0,1,1,0,0,0,0,0,0,1,1,0,0,0,0,0,0,0,0,0,0
,,Asian,101,41,60,0,99,40,59,0,40,20,20,0,18,10,8,0,7,4,3,0,13,4,9,0,0,0,0,0
,,American Indian/Alaska Native,192,78,114,0,188,77,111,0,48,30,18,0,25,18,7,0,10,8,2,0,18,11,7,0,1,1,0,0
,,Pacific Islander,14,8,6,0,14,8,6,0,3,1,2,0,1,0,1,0,0,0,0,0,0,0,0,0,0,0,0,0
,,Multiracial,49,28,21,0,49,28,21,0,21,16,5,0,14,11,3,0,4,3,1,0,4,4,0,0,1,1,0,0
,Arkansas,All Ethnicities,3121,1629,1492,0,2938,1524,1414,0,1766,1035,731,0,811,565,246,0,419,278,141,0,372,196,176,0,56,33,23,0
,,White,2534,1294,1240,0,2410,1220,1190,0,1436,820,616,0,651,448,203,0,339,215,124,0,293,148,145,0,42,24,18,0
,,Black,469,262,207,0,417,235,182,0,268,175,93,0,127,94,33,0,64,51,13,0,67,41,26,0,13,8,5,0
,,Hispanic,79,54,25,0,74,51,23,0,42,29,13,0,23,17,6,0,14,10,4,0,8,6,2,0,1,1,0,0
,,Asian,22,10,12,0,20,9,11,0,13,7,6,0,5,2,3,0,2,2,0,0,3,1,2,0,0,0,0,0
,,American Indian/Alaska Native,4,3,1,0,4,3,1,0,2,1,1,0,0,0,0,0,0,0,0,0,1,0,1,0,0,0,0,0
,,Pacific Islander,6,2,4,0,6,2,4,0,4,2,2,0,1,1,0,0,0,0,0,0,0,0,0,0,0,0,0,0
,,,,,,,,,,,,,,,,,,,,,,,,,,,,,,
,,,,,,,,,,,,,,,,,,,,,,,,,,,,,,
,,Multiracial,7,4,3,0,7,4,3,0,1,1,0,0,4,3,1,0,0,0,0,0,0,0,0,0,0,0,0,0
,California,All Ethnicities,39248,20681,18567,0,36774,19275,17499,0,18905,11616,7289,0,8565,6009,2556,0,4222,2908,1314,0,4479,2787,1692,0,158,87,71,0
,,White,20287,10393,9894,0,19063,9674,9389,0,9630,5685,3945,0,4227,2840,1387,0,2121,1387,734,0,1994,1133,861,0,57,31,26,0
,,Black,3080,1683,1397,0,2855,1543,1312,0,1702,1068,634,0,725,536,189,0,371,273,98,0,435,310,125,0,17,10,7,0
,,Hispanic,11956,6738,5218,0,11179,6313,4866,0,5831,3913,1918,0,3072,2293,779,0,1453,1081,372,0,1615,1117,498,0,72,41,31,0
,,Unknown,11,6,5,0,9,5,4,0,8,5,3,0,4,3,1,0,2,1,1,0,2,1,1,0,0,0,0,0
,,Asian,2967,1389,1578,0,2766,1295,1471,0,1345,719,626,0,375,227,148,0,200,118,82,0,339,175,164,0,9,3,6,0
,,American Indian/Alaska Native,127,66,61,0,122,63,59,0,55,35,20,0,33,25,8,0,16,11,5,0,16,9,7,0,1,1,0,0
,,Pacific Islander,395,191,204,0,376,178,198,0,119,64,55,0,42,23,19,0,21,13,8,0,39,21,18,0,1,1,0,0
,,Multiracial,425,215,210,0,404,204,200,0,215,127,88,0,87,62,25,0,38,24,14,0,39,21,18,0,1,0,1,0
,Colorado,All Ethnicities,5736,2950,2786,0,5354,2742,2612,0,2596,1531,1065,0,1210,827,383,0,756,476,280,0,494,291,203,0,42,23,19,0
,,White,4480,2263,2217,0,4193,2111,2082,0,2024,1177,847,0,945,640,305,0,612,380,232,0,378,223,155,0,33,18,15,0
,,Black,246,143,103,0,218,124,94,0,139,85,54,0,64,45,19,0,34,21,13,0,34,19,15,0,0,0,0,0
,,Hispanic,852,467,385,0,797,436,361,0,362,228,134,0,174,125,49,0,101,69,32,0,67,40,27,0,8,5,3,0
,,Unknown,2,1,1,0,2,1,1,0,1,1,0,0,1,1,0,0,0,0,0,0,0,0,0,0,0,0,0,0
,,Asian,99,46,53,0,94,44,50,0,48,26,22,0,13,6,7,0,6,4,2,0,8,3,5,0,0,0,0,0
,,American Indian/Alaska Native,30,18,12,0,27,16,11,0,17,11,6,0,13,10,3,0,3,2,1,0,7,6,1,0,1,0,1,0
,,Pacific Islander,8,6,2,0,7,5,2,0,2,2,0,0,0,0,0,0,0,0,0,0,0,0,0,0,0,0,0,0
,,Multiracial,19,6,13,0,16,5,11,0,3,1,2,0,0,0,0,0,0,0,0,0,0,0,0,0,0,0,0,0
,Connecticut,All Ethnicities,4061,2062,1999,0,3821,1929,1892,0,1664,1003,661,0,725,511,214,0,354,242,112,0,273,187,86,0,21,13,8,0
,,White,3112,1554,1558,0,2936,1460,1476,0,1230,713,517,0,515,345,170,0,251,158,93,0,186,126,60,0,11,6,5,0
,,Black,378,207,171,0,350,191,159,0,173,115,58,0,71,55,16,0,35,29,6,0,32,23,9,0,3,2,1,0
,,Hispanic,470,254,216,0,440,235,205,0,229,151,78,0,120,95,25,0,59,47,12,0,45,29,16,0,6,5,1,0
,,Unknown,2,1,1,0,2,1,1,0,0,0,0,0,2,1,1,0,1,1,0,0,0,0,0,0,0,0,0,0
,,Asian,64,29,35,0,61,27,34,0,21,16,5,0,10,10,0,0,5,4,1,0,6,5,1,0,0,0,0,0
,,American Indian/Alaska Native,5,2,3,0,5,2,3,0,2,2,0,0,2,2,0,0,2,2,0,0,2,2,0,0,0,0,0,0
,,Pacific Islander,6,4,2,0,6,4,2,0,0,0,0,0,1,1,0,0,0,0,0,0,0,0,0,0,0,0,0,0
,,Multiracial,24,11,13,0,21,9,12,0,9,6,3,0,4,2,2,0,1,1,0,0,2,2,0,0,1,0,1,0
,Delaware,All Ethnicities,1499,790,709,0,1386,723,663,0,857,503,354,0,328,222,106,0,204,139,65,0,199,126,73,0,13,10,3,0
,,White,1161,618,543,0,1090,575,515,0,655,381,274,0,251,165,86,0,147,97,50,0,143,86,57,0,5,4,1,0
,,Black,259,130,129,0,223,109,114,0,152,91,61,0,52,37,15,0,38,27,11,0,40,28,12,0,6,4,2,0
,,Hispanic,53,33,20,0,50,31,19,0,35,25,10,0,19,16,3,0,14,11,3,0,11,9,2,0,1,1,0,0
,,Asian,20,7,13,0,17,6,11,0,11,4,7,0,3,2,1,0,2,2,0,0,3,2,1,0,0,0,0,0
,,American Indian/Alaska Native,1,0,1,0,1,0,1,0,0,0,0,0,0,0,0,0,0,0,0,0,0,0,0,0,0,0,0,0
,,Pacific Islander,1,0,1,0,1,0,1,0,0,0,0,0,0,0,0,0,0,0,0,0,0,0,0,0,0,0,0,0
,,Multiracial,4,2,2,0,4,2,2,0,4,2,2,0,3,2,1,0,3,2,1,0,2,1,1,0,1,1,0,0
,District of Columbia,All Ethnicities,1034,562,472,0,955,516,439,0,475,291,184,0,185,138,47,0,156,116,40,0,112,67,45,0,8,6,2,0
,,White,261,134,127,0,246,126,120,0,75,50,25,0,24,16,8,0,21,14,7,0,18,10,8,0,1,1,0,0
,,Black,689,377,312,0,630,342,288,0,369,219,150,0,146,109,37,0,122,92,30,0,85,51,34,0,6,5,1,0
,,Hispanic,56,39,17,0,53,37,16,0,26,19,7,0,12,12,0,0,11,9,2,0,7,5,2,0,0,0,0,0
,,Asian,20,8,12,0,18,7,11,0,4,2,2,0,3,1,2,0,2,1,1,0,2,1,1,0,1,0,1,0
,,,,,,,,,,,,,,,,,,,,,,,,,,,,,,
,,,,,,,,,,,,,,,,,,,,,,,,,,,,,,
,,American Indian/Alaska Native,1,0,1,0,1,0,1,0,0,0,0,0,0,0,0,0,0,0,0,0,0,0,0,0,0,0,0,0
,,Pacific Islander,3,1,2,0,3,1,2,0,0,0,0,0,0,0,0,0,0,0,0,0,0,0,0,0,0,0,0,0
,,Multiracial,4,3,1,0,4,3,1,0,1,1,0,0,0,0,0,0,0,0,0,0,0,0,0,0,0,0,0,0
,Florida,All Ethnicities,20774,11142,9632,0,19064,10181,8883,0,11974,7148,4826,0,4588,3129,1459,0,2682,1805,877,0,2408,1392,1016,0,388,233,155,0
,,White,14346,7559,6787,0,13207,6948,6259,0,8138,4755,3383,0,3048,2049,999,0,1707,1109,598,0,1539,852,687,0,194,111,83,0
,,Black,2853,1614,1239,0,2528,1432,1096,0,1826,1131,695,0,709,511,198,0,458,338,120,0,435,285,150,0,84,57,27,0
,,Hispanic,3138,1746,1392,0,2930,1606,1324,0,1770,1128,642,0,751,513,238,0,472,328,144,0,379,229,150,0,102,60,42,0
,,Unknown,24,13,11,0,20,9,11,0,17,10,7,0,5,4,1,0,3,1,2,0,2,1,1,0,1,1,0,0
,,Asian,275,144,131,0,250,126,124,0,143,85,58,0,45,31,14,0,20,15,5,0,39,17,22,0,4,2,2,0
,,American Indian/Alaska Native,26,14,12,0,26,14,12,0,16,6,10,0,8,4,4,0,6,2,4,0,2,1,1,0,0,0,0,0
,,Pacific Islander,23,11,12,0,20,9,11,0,11,5,6,0,2,2,0,0,1,1,0,0,1,0,1,0,0,0,0,0
,,Multiracial,89,41,48,0,83,37,46,0,53,28,25,0,20,15,5,0,15,11,4,0,11,7,4,0,3,2,1,0
,Georgia,All Ethnicities,10557,5230,5327,0,9581,4659,4922,0,5562,3186,2376,0,2367,1601,766,0,981,692,289,0,1172,683,489,0,117,65,52,0
,,White,6890,3349,3541,0,6355,3042,3313,0,3497,1981,1516,0,1528,1009,519,0,652,435,217,0,684,391,293,0,69,36,33,0
,,Black,2972,1516,1456,0,2584,1282,1302,0,1706,987,719,0,652,463,189,0,251,199,52,0,394,237,157,0,35,23,12,0
,,Hispanic,482,272,210,0,442,249,193,0,269,171,98,0,152,107,45,0,64,47,17,0,69,43,26,0,7,2,5,0
,,Unknown,3,3,0,0,3,3,0,0,2,2,0,0,0,0,0,0,0,0,0,0,0,0,0,0,0,0,0,0
,,Asian,159,63,96,0,149,57,92,0,69,32,37,0,22,11,11,0,11,8,3,0,22,10,12,0,2,1,1,0
,,American Indian/Alaska Native,6,3,3,0,6,3,3,0,1,1,0,0,0,0,0,0,0,0,0,0,0,0,0,0,0,0,0,0
,,Pacific Islander,10,5,5,0,9,5,4,0,3,1,2,0,2,1,1,0,0,0,0,0,2,1,1,0,0,0,0,0
,,Multiracial,35,19,16,0,33,18,15,0,15,11,4,0,11,10,1,0,3,3,0,0,1,1,0,0,4,3,1,0
,Hawaii,All Ethnicities,1303,732,571,0,1256,709,547,0,594,382,212,0,69,56,13,0,109,84,25,0,32,15,17,0,1,1,0,0
,,White,443,266,177,0,429,259,170,0,174,123,51,0,29,24,5,0,39,33,6,0,13,9,4,0,0,0,0,0
,,Black,18,11,7,0,17,11,6,0,5,3,2,0,0,0,0,0,1,0,1,0,1,0,1,0,0,0,0,0
,,Hispanic,32,20,12,0,31,19,12,0,13,11,2,0,1,1,0,0,3,2,1,0,1,1,0,0,0,0,0,0
,,Unknown,5,3,2,0,5,3,2,0,3,2,1,0,0,0,0,0,0,0,0,0,0,0,0,0,0,0,0,0
,,Asian,430,217,213,0,413,209,204,0,210,119,91,0,15,13,2,0,27,18,9,0,10,2,8,0,1,1,0,0
,,American Indian/Alaska Native,4,3,1,0,4,3,1,0,0,0,0,0,1,1,0,0,0,0,0,0,0,0,0,0,0,0,0,0
,,Pacific Islander,273,165,108,0,261,160,101,0,151,101,50,0,21,15,6,0,32,26,6,0,7,3,4,0,0,0,0,0
,,Multiracial,98,47,51,0,96,45,51,0,38,23,15,0,2,2,0,0,7,5,2,0,0,0,0,0,0,0,0,0
,Idaho,All Ethnicities,1676,869,807,0,1601,825,776,0,779,484,295,0,374,257,117,0,201,138,63,0,148,99,49,0,15,6,9,0
,,White,1525,788,737,0,1459,749,710,0,708,437,271,0,337,232,105,0,183,128,55,0,131,87,44,0,11,5,6,0
,,Black,19,10,9,0,19,10,9,0,10,6,4,0,4,2,2,0,5,3,2,0,1,1,0,0,1,0,1,0
,,Hispanic,99,55,44,0,91,51,40,0,48,33,15,0,25,18,7,0,10,6,4,0,13,10,3,0,2,1,1,0
,,Asian,4,3,1,0,4,3,1,0,2,2,0,0,0,0,0,0,0,0,0,0,1,1,0,0,0,0,0,0
,,American Indian/Alaska Native,18,7,11,0,17,6,11,0,7,3,4,0,6,4,2,0,2,0,2,0,1,0,1,0,1,0,1,0
,,Pacific Islander,4,2,2,0,4,2,2,0,1,1,0,0,1,1,0,0,0,0,0,0,0,0,0,0,0,0,0,0
,,Multiracial,7,4,3,0,7,4,3,0,3,2,1,0,1,0,1,0,1,1,0,0,1,0,1,0,0,0,0,0
,Illinois,All Ethnicities,17991,9401,8590,0,16603,8634,7969,0,7906,4733,3173,0,3052,2090,962,0,2659,1717,942,0,1852,1144,708,0,159,100,59,0
,,White,11533,5850,5683,0,10707,5400,5307,0,5061,2906,2155,0,1911,1228,683,0,1707,1013,694,0,1098,625,473,0,89,55,34,0
,,Black,3569,2017,1552,0,3201,1808,1393,0,1893,1191,702,0,717,547,170,0,617,459,158,0,488,341,147,0,47,32,15,0
,,,,,,,,,,,,,,,,,,,,,,,,,,,,,,
,,,,,,,,,,,,,,,,,,,,,,,,,,,,,,
,,Hispanic,2390,1314,1076,0,2236,1225,1011,0,787,549,238,0,376,281,95,0,297,222,75,0,221,161,60,0,21,12,9,0
,,Unknown,3,1,2,0,2,1,1,0,2,1,1,0,0,0,0,0,1,1,0,0,0,0,0,0,0,0,0,0
,,Asian,383,175,208,0,353,160,193,0,136,75,61,0,37,27,10,0,30,17,13,0,41,17,24,0,1,0,1,0
,,American Indian/Alaska Native,13,7,6,0,11,6,5,0,6,2,4,0,2,1,1,0,2,1,1,0,2,0,2,0,0,0,0,0
,,Pacific Islander,30,12,18,0,28,12,16,0,9,4,5,0,1,1,0,0,3,2,1,0,0,0,0,0,0,0,0,0
,,Multiracial,70,25,45,0,65,22,43,0,12,5,7,0,8,5,3,0,2,2,0,0,2,0,2,0,1,1,0,0
,Indiana,All Ethnicities,7895,4048,3847,0,7467,3803,3664,0,4128,2436,1692,0,1950,1341,609,0,1218,796,422,0,1010,599,411,0,204,123,81,0
,,White,6696,3369,3327,0,6368,3183,3185,0,3447,2009,1438,0,1623,1111,512,0,995,631,364,0,823,469,354,0,164,94,70,0
,,Black,830,480,350,0,745,430,315,0,515,323,192,0,247,179,68,0,166,127,39,0,147,99,48,0,31,23,8,0
,,Hispanic,282,158,124,0,273,152,121,0,125,83,42,0,67,43,24,0,45,31,14,0,33,25,8,0,8,5,3,0
,,Unknown,1,1,0,0,1,1,0,0,1,1,0,0,0,0,0,0,0,0,0,0,0,0,0,0,0,0,0,0
,,Asian,63,30,33,0,59,28,31,0,31,17,14,0,8,5,3,0,11,6,5,0,7,6,1,0,1,1,0,0
,,American Indian/Alaska Native,4,1,3,0,4,1,3,0,2,0,2,0,1,0,1,0,0,0,0,0,0,0,0,0,0,0,0,0
,,Pacific Islander,6,2,4,0,5,2,3,0,4,1,3,0,1,1,0,0,1,1,0,0,0,0,0,0,0,0,0,0
,,Multiracial,13,7,6,0,12,6,6,0,3,2,1,0,3,2,1,0,0,0,0,0,0,0,0,0,0,0,0,0
,Iowa,All Ethnicities,3825,1926,1899,0,3666,1840,1826,0,1674,981,693,0,719,466,253,0,561,355,206,0,353,192,161,0,39,16,23,0
,,White,3582,1778,1804,0,3440,1704,1736,0,1557,905,652,0,662,425,237,0,529,330,199,0,318,168,150,0,30,13,17,0
,,Black,116,74,42,0,107,68,39,0,58,41,17,0,32,26,6,0,16,15,1,0,17,16,1,0,5,2,3,0
,,Hispanic,90,58,32,0,83,53,30,0,40,28,12,0,19,13,6,0,11,8,3,0,11,7,4,0,3,1,2,0
,,Asian,28,9,19,0,28,9,19,0,18,6,12,0,5,1,4,0,4,1,3,0,6,0,6,0,1,0,1,0
,,American Indian/Alaska Native,7,7,0,0,6,6,0,0,1,1,0,0,1,1,0,0,1,1,0,0,1,1,0,0,0,0,0,0
,,Multiracial,2,0,2,0,2,0,2,0,0,0,0,0,0,0,0,0,0,0,0,0,0,0,0,0,0,0,0,0
,Kansas,All Ethnicities,3656,2011,1645,0,3431,1880,1551,0,2141,1303,838,0,937,650,287,0,659,431,228,0,501,313,188,0,51,30,21,0
,,White,3086,1692,1394,0,2901,1582,1319,0,1767,1075,692,0,763,536,227,0,546,357,189,0,390,237,153,0,42,24,18,0
,,Black,233,126,107,0,213,115,98,0,159,94,65,0,65,42,23,0,39,25,14,0,45,31,14,0,3,3,0,0
,,Hispanic,272,165,107,0,255,156,99,0,176,114,62,0,91,61,30,0,62,41,21,0,54,37,17,0,3,2,1,0
,,Unknown,1,1,0,0,1,1,0,0,1,1,0,0,0,0,0,0,0,0,0,0,0,0,0,0,0,0,0,0
,,Asian,35,14,21,0,34,14,20,0,24,11,13,0,10,6,4,0,5,3,2,0,5,2,3,0,1,0,1,0
,,American Indian/Alaska Native,16,10,6,0,15,9,6,0,10,7,3,0,6,4,2,0,4,4,0,0,6,5,1,0,1,1,0,0
,,Pacific Islander,4,0,4,0,4,0,4,0,1,0,1,0,1,0,1,0,1,0,1,0,0,0,0,0,0,0,0,0
,,Multiracial,9,3,6,0,8,3,5,0,3,1,2,0,1,1,0,0,2,1,1,0,1,1,0,0,1,0,1,0
,Kentucky,All Ethnicities,4756,2495,2261,0,4521,2340,2181,0,2486,1520,966,0,1091,753,338,0,701,458,243,0,542,336,206,0,47,23,24,0
,,White,4275,2213,2062,0,4069,2083,1986,0,2200,1338,862,0,968,664,304,0,613,391,222,0,467,284,183,0,40,18,22,0
,,Black,373,222,151,0,350,202,148,0,226,143,83,0,91,68,23,0,66,51,15,0,62,44,18,0,6,4,2,0
,,Hispanic,67,36,31,0,62,32,30,0,41,28,13,0,23,16,7,0,15,11,4,0,7,5,2,0,0,0,0,0
,,Asian,24,16,8,0,24,16,8,0,10,7,3,0,4,3,1,0,3,3,0,0,3,2,1,0,0,0,0,0
,,American Indian/Alaska Native,3,1,2,0,2,0,2,0,2,1,1,0,1,0,1,0,1,0,1,0,0,0,0,0,0,0,0,0
,,Pacific Islander,4,1,3,0,4,1,3,0,1,0,1,0,1,0,1,0,0,0,0,0,0,0,0,0,0,0,0,0
,,Multiracial,10,6,4,0,10,6,4,0,6,3,3,0,3,2,1,0,3,2,1,0,3,1,2,0,1,1,0,0
,Louisiana,All Ethnicities,5950,3242,2708,0,5436,2952,2484,0,3652,2229,1423,0,1498,1070,428,0,984,680,304,0,822,514,308,0,77,47,30,0
,,White,3898,2099,1799,0,3650,1956,1694,0,2379,1463,916,0,1026,738,288,0,698,474,224,0,532,327,205,0,48,29,19,0
,,,,,,,,,,,,,,,,,,,,,,,,,,,,,,
,,,,,,,,,,,,,,,,,,,,,,,,,,,,,,
,,Black,1842,1025,817,0,1600,893,707,0,1162,693,469,0,415,295,120,0,262,190,72,0,269,175,94,0,28,18,10,0
,,Hispanic,128,75,53,0,108,63,45,0,75,49,26,0,42,28,14,0,13,9,4,0,17,11,6,0,1,0,1,0
,,Unknown,1,1,0,0,1,1,0,0,1,1,0,0,1,1,0,0,0,0,0,0,0,0,0,0,0,0,0,0
,,Asian,63,33,30,0,60,31,29,0,30,18,12,0,12,6,6,0,9,5,4,0,4,1,3,0,0,0,0,0
,,American Indian/Alaska Native,10,5,5,0,9,4,5,0,3,3,0,0,2,2,0,0,2,2,0,0,0,0,0,0,0,0,0,0
,,Pacific Islander,1,0,1,0,1,0,1,0,0,0,0,0,0,0,0,0,0,0,0,0,0,0,0,0,0,0,0,0
,,Multiracial,7,4,3,0,7,4,3,0,2,2,0,0,0,0,0,0,0,0,0,0,0,0,0,0,0,0,0,0
,Maine,All Ethnicities,1770,919,851,0,1649,851,798,0,783,479,304,0,336,233,103,0,208,132,76,0,136,85,51,0,17,8,9,0
,,White,1704,878,826,0,1590,815,775,0,752,458,294,0,322,223,99,0,199,126,73,0,132,84,48,0,15,7,8,0
,,Black,30,20,10,0,25,17,8,0,13,10,3,0,4,3,1,0,4,4,0,0,1,0,1,0,0,0,0,0
,,Hispanic,21,11,10,0,20,10,10,0,10,5,5,0,7,4,3,0,4,1,3,0,2,1,1,0,2,1,1,0
,,Asian,9,5,4,0,8,4,4,0,5,3,2,0,1,1,0,0,1,1,0,0,1,0,1,0,0,0,0,0
,,American Indian/Alaska Native,1,1,0,0,1,1,0,0,0,0,0,0,0,0,0,0,0,0,0,0,0,0,0,0,0,0,0,0
,,Multiracial,5,4,1,0,5,4,1,0,3,3,0,0,2,2,0,0,0,0,0,0,0,0,0,0,0,0,0,0
,Maryland,All Ethnicities,8941,4398,4543,0,8304,4023,4281,0,4035,2384,1651,0,1436,966,470,0,1162,774,388,0,1007,612,395,0,54,29,25,0
,,White,5389,2652,2737,0,5022,2438,2584,0,2481,1444,1037,0,851,552,299,0,698,438,260,0,559,333,226,0,31,17,14,0
,,Black,2891,1407,1484,0,2649,1266,1383,0,1276,761,515,0,482,336,146,0,376,275,101,0,355,219,136,0,15,9,6,0
,,Hispanic,346,204,142,0,334,198,136,0,163,114,49,0,73,59,14,0,61,45,16,0,57,41,16,0,7,2,5,0
,,Unknown,3,1,2,0,3,1,2,0,0,0,0,0,0,0,0,0,0,0,0,0,0,0,0,0,0,0,0,0
,,Asian,230,98,132,0,215,84,131,0,98,56,42,0,26,17,9,0,20,12,8,0,33,17,16,0,1,1,0,0
,,American Indian/Alaska Native,14,5,9,0,14,5,9,0,2,2,0,0,0,0,0,0,0,0,0,0,0,0,0,0,0,0,0,0
,,Pacific Islander,27,13,14,0,27,13,14,0,5,3,2,0,1,0,1,0,3,2,1,0,1,1,0,0,0,0,0,0
,,Multiracial,41,18,23,0,40,18,22,0,10,4,6,0,3,2,1,0,4,2,2,0,2,1,1,0,0,0,0,0
,Massachusetts,All Ethnicities,7947,3995,3952,0,7368,3671,3697,0,3063,1804,1259,0,1242,822,420,0,615,416,199,0,536,325,211,0,34,20,14,0
,,White,6599,3255,3344,0,6108,2986,3122,0,2503,1432,1071,0,977,629,348,0,477,311,166,0,421,249,172,0,23,13,10,0
,,Black,468,251,217,0,439,232,207,0,176,119,57,0,83,58,25,0,39,33,6,0,40,29,11,0,3,2,1,0
,,Hispanic,664,384,280,0,619,357,262,0,306,209,97,0,157,115,42,0,84,63,21,0,62,41,21,0,6,3,3,0
,,Unknown,4,4,0,0,4,4,0,0,2,2,0,0,2,2,0,0,1,1,0,0,0,0,0,0,0,0,0,0
,,Asian,166,74,92,0,154,67,87,0,56,27,29,0,13,9,4,0,11,5,6,0,13,6,7,0,1,1,0,0
,,American Indian/Alaska Native,7,6,1,0,7,6,1,0,4,4,0,0,3,3,0,0,1,1,0,0,0,0,0,0,0,0,0,0
,,Pacific Islander,4,2,2,0,4,2,2,0,0,0,0,0,0,0,0,0,0,0,0,0,0,0,0,0,0,0,0,0
,,Multiracial,35,19,16,0,33,17,16,0,16,11,5,0,7,6,1,0,2,2,0,0,0,0,0,0,1,1,0,0
,Michigan,All Ethnicities,14393,7209,7184,0,13598,6782,6816,0,6036,3525,2511,0,2549,1689,860,0,1425,947,478,0,1555,889,666,0,154,87,67,0
,,White,11671,5793,5878,0,11101,5492,5609,0,4794,2764,2030,0,2010,1322,688,0,1146,741,405,0,1190,659,531,0,108,56,52,0
,,Black,2081,1105,976,0,1893,1001,892,0,1001,623,378,0,431,303,128,0,237,177,60,0,292,189,103,0,41,30,11,0
,,Hispanic,406,217,189,0,373,196,177,0,173,108,65,0,80,50,30,0,29,21,8,0,47,32,15,0,3,1,2,0
,,Unknown,3,1,2,0,3,1,2,0,0,0,0,0,0,0,0,0,0,0,0,0,0,0,0,0,0,0,0,0
,,Asian,151,55,96,0,147,54,93,0,50,20,30,0,20,9,11,0,9,6,3,0,22,6,16,0,2,0,2,0
,,American Indian/Alaska Native,33,18,15,0,33,18,15,0,9,6,3,0,2,1,1,0,1,1,0,0,1,0,1,0,0,0,0,0
,,Pacific Islander,17,9,8,0,17,9,8,0,5,3,2,0,3,3,0,0,2,1,1,0,1,1,0,0,0,0,0,0
,,Multiracial,31,11,20,0,31,11,20,0,4,1,3,0,3,1,2,0,1,0,1,0,2,2,0,0,0,0,0,0
,,,,,,,,,,,,,,,,,,,,,,,,,,,,,,
,,,,,,,,,,,,,,,,,,,,,,,,,,,,,,
,Minnesota,All Ethnicities,8474,4143,4331,0,8017,3902,4115,0,3091,1785,1306,0,1307,829,478,0,1403,857,546,0,697,410,287,0,90,54,36,0
,,White,7633,3703,3930,0,7227,3498,3729,0,2800,1606,1194,0,1173,741,432,0,1280,778,502,0,620,364,256,0,81,50,31,0
,,Black,338,190,148,0,317,174,143,0,128,89,39,0,58,44,14,0,60,43,17,0,35,26,9,0,2,2,0,0
,,Hispanic,205,116,89,0,191,106,85,0,84,51,33,0,40,26,14,0,31,21,10,0,17,8,9,0,2,1,1,0
,,Unknown,6,3,3,0,5,3,2,0,1,1,0,0,1,1,0,0,1,1,0,0,1,0,1,0,0,0,0,0
,,Asian,148,72,76,0,141,68,73,0,34,16,18,0,15,8,7,0,13,7,6,0,15,6,9,0,2,0,2,0
,,American Indian/Alaska Native,115,48,67,0,110,45,65,0,35,18,17,0,15,6,9,0,13,5,8,0,6,4,2,0,1,0,1,0
,,Pacific Islander,6,2,4,0,6,2,4,0,2,1,1,0,1,1,0,0,2,1,1,0,1,1,0,0,0,0,0,0
,,Multiracial,23,9,14,0,20,6,14,0,7,3,4,0,4,2,2,0,3,1,2,0,2,1,1,0,2,1,1,0
,Mississippi,All Ethnicities,3136,1633,1503,0,2933,1518,1415,0,1726,1014,712,0,721,479,242,0,395,258,137,0,316,198,118,0,63,36,27,0
,,White,2184,1095,1089,0,2061,1029,1032,0,1159,655,504,0,488,308,180,0,272,169,103,0,179,109,70,0,41,22,19,0
,,Black,884,499,385,0,811,454,357,0,530,334,196,0,214,155,59,0,117,84,33,0,130,83,47,0,20,13,7,0
,,Hispanic,37,21,16,0,32,18,14,0,22,14,8,0,12,10,2,0,3,3,0,0,4,4,0,0,0,0,0,0
,,Asian,20,12,8,0,19,11,8,0,9,7,2,0,5,5,0,0,1,1,0,0,3,2,1,0,1,1,0,0
,,American Indian/Alaska Native,6,3,3,0,6,3,3,0,3,2,1,0,2,1,1,0,1,0,1,0,0,0,0,0,1,0,1,0
,,Pacific Islander,1,1,0,0,1,1,0,0,0,0,0,0,0,0,0,0,0,0,0,0,0,0,0,0,0,0,0,0
,,Multiracial,4,2,2,0,3,2,1,0,3,2,1,0,0,0,0,0,1,1,0,0,0,0,0,0,0,0,0,0
,Missouri,All Ethnicities,7950,4199,3751,0,7236,3799,3437,0,4631,2714,1917,0,1863,1247,616,0,1127,735,392,0,1218,745,473,0,102,59,43,0
,,White,6543,3395,3148,0,6036,3117,2919,0,3713,2138,1575,0,1498,981,517,0,931,586,345,0,937,564,373,0,73,38,35,0
,,Black,1131,657,474,0,957,554,403,0,763,478,285,0,301,220,81,0,159,121,38,0,233,151,82,0,23,18,5,0
,,Hispanic,162,98,64,0,141,85,56,0,95,66,29,0,42,32,10,0,25,20,5,0,29,20,9,0,3,1,2,0
,,Asian,68,25,43,0,61,23,38,0,34,15,19,0,10,6,4,0,7,3,4,0,13,6,7,0,3,2,1,0
,,American Indian/Alaska Native,20,10,10,0,16,7,9,0,13,8,5,0,5,2,3,0,3,3,0,0,3,2,1,0,0,0,0,0
,,Pacific Islander,9,6,3,0,9,6,3,0,6,4,2,0,4,4,0,0,2,2,0,0,3,2,1,0,0,0,0,0
,,Multiracial,17,8,9,0,16,7,9,0,7,5,2,0,3,2,1,0,0,0,0,0,0,0,0,0,0,0,0,0
,Montana,All Ethnicities,1236,614,622,0,1178,579,599,0,577,340,237,0,295,202,93,0,171,115,56,0,104,59,45,0,11,8,3,0
,,White,1131,570,561,0,1077,538,539,0,534,317,217,0,276,194,82,0,158,105,53,0,95,56,39,0,10,8,2,0
,,Black,6,4,2,0,5,3,2,0,4,4,0,0,1,1,0,0,2,2,0,0,1,1,0,0,0,0,0,0
,,Hispanic,22,11,11,0,21,10,11,0,13,4,9,0,5,1,4,0,3,2,1,0,4,0,4,0,0,0,0,0
,,Asian,4,2,2,0,4,2,2,0,4,2,2,0,2,1,1,0,1,1,0,0,0,0,0,0,0,0,0,0
,,American Indian/Alaska Native,70,24,46,0,68,23,45,0,20,11,9,0,11,5,6,0,6,4,2,0,4,2,2,0,1,0,1,0
,,Multiracial,3,3,0,0,3,3,0,0,2,2,0,0,0,0,0,0,1,1,0,0,0,0,0,0,0,0,0,0
,Nebraska,All Ethnicities,2312,1134,1178,0,2183,1070,1113,0,1139,626,513,0,443,282,161,0,422,254,168,0,231,131,100,0,35,16,19,0
,,White,2034,994,1040,0,1919,938,981,0,986,541,445,0,375,237,138,0,381,230,151,0,196,112,84,0,29,13,16,0
,,Black,120,57,63,0,112,52,60,0,72,37,35,0,29,18,11,0,24,14,10,0,17,9,8,0,0,0,0,0
,,Hispanic,117,69,48,0,112,66,46,0,59,39,20,0,31,21,10,0,10,6,4,0,12,6,6,0,6,3,3,0
,,Asian,20,6,14,0,19,6,13,0,12,3,9,0,1,1,0,0,4,1,3,0,5,3,2,0,0,0,0,0
,,American Indian/Alaska Native,15,5,10,0,15,5,10,0,7,4,3,0,5,3,2,0,2,2,0,0,0,0,0,0,0,0,0,0
,,Multiracial,6,3,3,0,6,3,3,0,3,2,1,0,2,2,0,0,1,1,0,0,1,1,0,0,0,0,0,0
,Nevada,All Ethnicities,2972,1564,1408,0,2769,1440,1329,0,1687,964,723,0,706,461,245,0,310,212,98,0,344,192,152,0,21,14,7,0
,,White,2046,1060,986,0,1929,994,935,0,1148,648,500,0,474,302,172,0,212,142,70,0,197,103,94,0,13,8,5,0
,,,,,,,,,,,,,,,,,,,,,,,,,,,,,,
,,,,,,,,,,,,,,,,,,,,,,,,,,,,,,
,,Black,259,127,132,0,234,112,122,0,151,76,75,0,56,32,24,0,25,13,12,0,34,20,14,0,1,1,0,0
,,Hispanic,449,268,181,0,413,246,167,0,266,179,87,0,140,105,35,0,53,44,9,0,70,52,18,0,7,5,2,0
,,Asian,146,70,76,0,128,55,73,0,84,38,46,0,23,13,10,0,12,6,6,0,35,11,24,0,0,0,0,0
,,American Indian/Alaska Native,18,11,7,0,17,10,7,0,5,4,1,0,4,4,0,0,1,1,0,0,0,0,0,0,0,0,0,0
,,Pacific Islander,26,12,14,0,24,11,13,0,18,9,9,0,4,2,2,0,3,3,0,0,3,2,1,0,0,0,0,0
,,Multiracial,28,16,12,0,24,12,12,0,15,10,5,0,5,3,2,0,4,3,1,0,5,4,1,0,0,0,0,0
,New Hampshire,All Ethnicities,1687,833,854,0,1575,769,806,0,664,391,273,0,270,173,97,0,157,99,58,0,140,71,69,0,3,3,0,0
,,White,1609,790,819,0,1504,732,772,0,628,370,258,0,251,161,90,0,148,96,52,0,128,66,62,0,3,3,0,0
,,Black,23,12,11,0,19,8,11,0,14,8,6,0,8,6,2,0,5,3,2,0,4,2,2,0,0,0,0,0
,,Hispanic,36,21,15,0,35,20,15,0,15,9,6,0,6,3,3,0,3,0,3,0,5,2,3,0,0,0,0,0
,,Asian,16,9,7,0,14,8,6,0,5,3,2,0,3,2,1,0,0,0,0,0,2,1,1,0,0,0,0,0
,,Multiracial,3,1,2,0,3,1,2,0,2,1,1,0,2,1,1,0,1,0,1,0,1,0,1,0,0,0,0,0
,New Jersey,All Ethnicities,11172,5424,5748,0,10535,5075,5460,0,4616,2625,1991,0,1803,1155,648,0,1096,684,412,0,784,450,334,0,43,23,20,0
,,White,7193,3433,3760,0,6790,3217,3573,0,2910,1636,1274,0,1083,672,411,0,669,403,266,0,445,244,201,0,20,12,8,0
,,Black,1701,834,867,0,1586,767,819,0,772,423,349,0,302,196,106,0,187,117,70,0,139,89,50,0,15,7,8,0
,,Hispanic,1708,897,811,0,1618,848,770,0,728,453,275,0,359,249,110,0,201,142,59,0,155,97,58,0,6,3,3,0
,,Unknown,3,3,0,0,3,3,0,0,2,2,0,0,2,2,0,0,2,2,0,0,1,1,0,0,0,0,0,0
,,Asian,483,222,261,0,456,205,251,0,170,98,72,0,42,29,13,0,29,17,12,0,31,14,17,0,1,1,0,0
,,American Indian/Alaska Native,7,2,5,0,7,2,5,0,1,1,0,0,0,0,0,0,0,0,0,0,1,1,0,0,0,0,0,0
,,Pacific Islander,27,12,15,0,25,12,13,0,11,4,7,0,2,1,1,0,3,0,3,0,5,1,4,0,1,0,1,0
,,Multiracial,50,21,29,0,50,21,29,0,22,8,14,0,13,6,7,0,5,3,2,0,7,3,4,0,0,0,0,0
,New Mexico,All Ethnicities,2328,1222,1106,0,2199,1150,1049,0,1184,688,496,0,543,380,163,0,201,129,72,0,194,121,73,0,19,14,5,0
,,White,1170,612,558,0,1100,566,534,0,601,334,267,0,252,173,79,0,101,60,41,0,96,64,32,0,8,6,2,0
,,Black,53,25,28,0,50,24,26,0,37,20,17,0,14,10,4,0,6,4,2,0,5,2,3,0,0,0,0,0
,,Hispanic,991,540,451,0,943,519,424,0,502,310,192,0,257,181,76,0,89,61,28,0,87,51,36,0,10,8,2,0
,,Asian,19,8,11,0,17,6,11,0,13,6,7,0,3,2,1,0,0,0,0,0,1,0,1,0,0,0,0,0
,,American Indian/Alaska Native,79,31,48,0,74,30,44,0,26,16,10,0,15,13,2,0,5,4,1,0,5,4,1,0,0,0,0,0
,,Pacific Islander,1,0,1,0,1,0,1,0,0,0,0,0,0,0,0,0,0,0,0,0,0,0,0,0,0,0,0,0
,,Multiracial,15,6,9,0,14,5,9,0,5,2,3,0,2,1,1,0,0,0,0,0,0,0,0,0,1,0,1,0
,New York,All Ethnicities,22604,11283,11321,0,20099,9969,10130,0,9863,5566,4297,0,3344,2240,1104,0,1763,1120,643,0,1127,644,483,0,140,84,56,0
,,White,13911,6840,7071,0,12481,6097,6384,0,5931,3244,2687,0,1912,1222,690,0,1076,658,418,0,664,346,318,0,75,46,29,0
,,Black,3547,1785,1762,0,3077,1549,1528,0,1668,945,723,0,589,403,186,0,300,210,90,0,200,129,71,0,31,16,15,0
,,Hispanic,4067,2173,1894,0,3594,1907,1687,0,1815,1140,675,0,714,529,185,0,309,206,103,0,217,148,69,0,25,16,9,0
,,Unknown,6,3,3,0,6,3,3,0,2,1,1,0,1,0,1,0,1,1,0,0,0,0,0,0,0,0,0,0
,,Asian,739,303,436,0,655,265,390,0,286,136,150,0,60,35,25,0,47,22,25,0,29,10,19,0,4,2,2,0
,,American Indian/Alaska Native,34,17,17,0,31,16,15,0,9,7,2,0,8,6,2,0,2,2,0,0,2,2,0,0,0,0,0,0
,,Pacific Islander,44,20,24,0,41,18,23,0,11,7,4,0,0,0,0,0,1,1,0,0,2,2,0,0,0,0,0,0
,,Multiracial,256,142,114,0,214,114,100,0,141,86,55,0,60,45,15,0,27,20,7,0,13,7,6,0,5,4,1,0
,North Carolina,All Ethnicities,10187,5299,4888,0,9526,4908,4618,0,5121,3014,2107,0,2438,1662,776,0,1520,1006,514,0,1328,810,518,0,127,73,54,0
,,White,7362,3759,3603,0,6924,3506,3418,0,3638,2096,1542,0,1727,1160,567,0,1092,694,398,0,866,509,357,0,66,40,26,0
,,Black,2237,1194,1043,0,2044,1073,971,0,1163,694,469,0,536,361,175,0,328,240,88,0,353,222,131,0,45,22,23,0
,,,,,,,,,,,,,,,,,,,,,,,,,,,,,,
,,,,,,,,,,,,,,,,,,,,,,,,,,,,,,
,,Hispanic,360,236,124,0,341,225,116,0,214,157,57,0,132,110,22,0,72,51,21,0,77,57,20,0,13,8,5,0
,,Unknown,2,1,1,0,2,1,1,0,2,1,1,0,1,0,1,0,1,0,1,0,0,0,0,0,0,0,0,0
,,Asian,84,45,39,0,80,42,38,0,44,29,15,0,16,10,6,0,11,7,4,0,13,7,6,0,1,1,0,0
,,American Indian/Alaska Native,98,43,55,0,93,42,51,0,47,27,20,0,20,15,5,0,15,13,2,0,13,9,4,0,2,2,0,0
,,Pacific Islander,4,2,2,0,4,2,2,0,1,1,0,0,1,1,0,0,0,0,0,0,1,1,0,0,0,0,0,0
,,Multiracial,40,19,21,0,38,17,21,0,12,9,3,0,5,5,0,0,1,1,0,0,5,5,0,0,0,0,0,0
,North Dakota,All Ethnicities,1029,497,532,0,985,476,509,0,399,229,170,0,171,119,52,0,182,115,67,0,76,39,37,0,14,8,6,0
,,White,916,441,475,0,872,420,452,0,372,212,160,0,155,107,48,0,169,107,62,0,66,34,32,0,12,6,6,0
,,Black,12,7,5,0,12,7,5,0,7,5,2,0,3,1,2,0,1,1,0,0,3,1,2,0,1,1,0,0
,,Hispanic,16,11,5,0,16,11,5,0,5,3,2,0,3,2,1,0,2,0,2,0,2,1,1,0,0,0,0,0
,,Asian,5,0,5,0,5,0,5,0,1,0,1,0,0,0,0,0,0,0,0,0,0,0,0,0,0,0,0,0
,,American Indian/Alaska Native,75,36,39,0,75,36,39,0,13,8,5,0,9,8,1,0,9,6,3,0,5,3,2,0,1,1,0,0
,,Pacific Islander,1,0,1,0,1,0,1,0,0,0,0,0,0,0,0,0,0,0,0,0,0,0,0,0,0,0,0,0
,,Multiracial,4,2,2,0,4,2,2,0,1,1,0,0,1,1,0,0,1,1,0,0,0,0,0,0,0,0,0,0
,Ohio,All Ethnicities,15946,8032,7914,0,15033,7522,7511,0,7422,4361,3061,0,3000,1993,1007,0,2377,1544,833,0,1675,958,717,0,137,83,54,0
,,White,13467,6711,6756,0,12746,6314,6432,0,6173,3573,2600,0,2469,1605,864,0,1962,1246,716,0,1324,726,598,0,110,66,44,0
,,Black,2067,1114,953,0,1897,1013,884,0,1077,679,398,0,445,326,119,0,351,251,100,0,305,201,104,0,20,12,8,0
,,Hispanic,236,119,117,0,224,114,110,0,108,64,44,0,62,42,20,0,40,28,12,0,29,18,11,0,4,3,1,0
,,Unknown,3,2,1,0,3,2,1,0,1,1,0,0,1,1,0,0,0,0,0,0,0,0,0,0,0,0,0,0
,,Asian,112,60,52,0,106,56,50,0,48,32,16,0,17,14,3,0,18,13,5,0,12,9,3,0,2,1,1,0
,,American Indian/Alaska Native,5,3,2,0,4,2,2,0,2,2,0,0,0,0,0,0,0,0,0,0,0,0,0,0,0,0,0,0
,,Pacific Islander,5,1,4,0,5,1,4,0,0,0,0,0,0,0,0,0,0,0,0,0,0,0,0,0,0,0,0,0
,,Multiracial,51,22,29,0,48,20,28,0,13,10,3,0,6,5,1,0,6,6,0,0,5,4,1,0,1,1,0,0
,Oklahoma,All Ethnicities,4334,2341,1993,0,4076,2184,1892,0,2430,1430,1000,0,1094,729,365,0,392,276,116,0,454,293,161,0,31,15,16,0
,,White,3568,1933,1635,0,3363,1812,1551,0,1992,1169,823,0,899,600,299,0,312,217,95,0,355,231,124,0,25,12,13,0
,,Black,341,187,154,0,315,167,148,0,207,131,76,0,91,67,24,0,34,25,9,0,50,32,18,0,4,2,2,0
,,Hispanic,191,115,76,0,178,106,72,0,110,68,42,0,51,36,15,0,28,21,7,0,30,21,9,0,1,0,1,0
,,Asian,35,16,19,0,34,15,19,0,20,9,11,0,8,3,5,0,1,0,1,0,1,0,1,0,1,1,0,0
,,American Indian/Alaska Native,179,78,101,0,167,73,94,0,93,48,45,0,39,19,20,0,14,11,3,0,17,9,8,0,0,0,0,0
,,Pacific Islander,7,3,4,0,7,3,4,0,3,1,2,0,2,1,1,0,1,1,0,0,1,0,1,0,0,0,0,0
,,Multiracial,13,9,4,0,12,8,4,0,5,4,1,0,4,3,1,0,2,1,1,0,0,0,0,0,0,0,0,0
,Oregon,All Ethnicities,3813,1892,1921,0,3681,1817,1864,0,1709,995,714,0,765,504,261,0,414,282,132,0,272,159,113,0,10,7,3,0
,,White,3405,1672,1733,0,3289,1602,1687,0,1531,879,652,0,664,435,229,0,369,252,117,0,230,127,103,0,9,6,3,0
,,Black,57,36,21,0,54,35,19,0,30,22,8,0,18,13,5,0,6,5,1,0,4,4,0,0,0,0,0,0
,,Hispanic,214,125,89,0,207,123,84,0,95,66,29,0,62,44,18,0,30,22,8,0,23,18,5,0,1,1,0,0
,,Asian,81,32,49,0,80,32,48,0,32,15,17,0,13,5,8,0,7,2,5,0,9,4,5,0,0,0,0,0
,,American Indian/Alaska Native,15,6,9,0,14,6,8,0,4,1,3,0,1,1,0,0,0,0,0,0,0,0,0,0,0,0,0,0
,,Pacific Islander,22,11,11,0,20,10,10,0,9,6,3,0,4,3,1,0,1,1,0,0,4,4,0,0,0,0,0,0
,,Multiracial,19,10,9,0,17,9,8,0,8,6,2,0,3,3,0,0,1,0,1,0,2,2,0,0,0,0,0,0
,Pennsylvania,All Ethnicities,19932,10562,9370,0,18342,9665,8677,0,11001,6496,4505,0,4008,2724,1284,0,2693,1729,964,0,2271,1383,888,0,178,105,73,0
,,White,16359,8510,7849,0,15104,7816,7288,0,8905,5162,3743,0,3172,2128,1044,0,2184,1348,836,0,1742,1015,727,0,145,84,61,0
,,,,,,,,,,,,,,,,,,,,,,,,,,,,,,
,,,,,,,,,,,,,,,,,,,,,,,,,,,,,,
,,Black,2377,1376,1001,0,2144,1236,908,0,1433,909,524,0,546,391,155,0,356,272,84,0,346,250,96,0,22,16,6,0
,,Hispanic,888,514,374,0,805,463,342,0,523,343,180,0,235,168,67,0,129,94,35,0,140,96,44,0,10,5,5,0
,,Unknown,1,1,0,0,1,1,0,0,1,1,0,0,0,0,0,0,0,0,0,0,0,0,0,0,0,0,0,0
,,Asian,229,114,115,0,212,104,108,0,104,58,46,0,35,21,14,0,18,11,7,0,31,14,17,0,1,0,1,0
,,American Indian/Alaska Native,10,7,3,0,9,6,3,0,5,3,2,0,5,4,1,0,1,0,1,0,2,2,0,0,0,0,0,0
,,Pacific Islander,13,8,5,0,13,8,5,0,2,1,1,0,0,0,0,0,0,0,0,0,0,0,0,0,0,0,0,0
,,Multiracial,55,32,23,0,54,31,23,0,28,19,9,0,15,12,3,0,5,4,1,0,10,6,4,0,0,0,0,0
,Puerto Rico,All Ethnicities,2737,1500,1237,0,2451,1328,1123,0,1567,959,608,0,355,287,68,0,245,184,61,0,246,174,72,0,29,20,9,0
,,White,61,29,32,0,56,25,31,0,11,9,2,0,3,2,1,0,0,0,0,0,1,1,0,0,1,1,0,0
,,Black,7,2,5,0,7,2,5,0,1,1,0,0,1,1,0,0,1,1,0,0,1,1,0,0,0,0,0,0
,,Hispanic,1983,1055,928,0,1801,948,853,0,972,588,384,0,237,187,50,0,137,100,37,0,106,73,33,0,21,15,6,0
,,Unknown,1,1,0,0,1,1,0,0,0,0,0,0,0,0,0,0,0,0,0,0,0,0,0,0,0,0,0,0
,,Asian,1,0,1,0,1,0,1,0,0,0,0,0,0,0,0,0,0,0,0,0,0,0,0,0,0,0,0,0
,,Multiracial,684,413,271,0,585,352,233,0,583,361,222,0,114,97,17,0,107,83,24,0,138,99,39,0,7,4,3,0
,Rhode Island,All Ethnicities,1229,577,652,0,1154,534,620,0,393,229,164,0,178,112,66,0,102,63,39,0,62,30,32,0,4,3,1,0
,,White,1033,472,561,0,970,436,534,0,328,188,140,0,148,90,58,0,86,53,33,0,56,26,30,0,2,1,1,0
,,Black,63,32,31,0,61,32,29,0,16,12,4,0,7,6,1,0,1,1,0,0,1,1,0,0,0,0,0,0
,,Hispanic,105,56,49,0,96,50,46,0,42,24,18,0,19,14,5,0,12,7,5,0,4,2,2,0,2,2,0,0
,,Asian,17,9,8,0,17,9,8,0,4,2,2,0,2,0,2,0,2,1,1,0,1,1,0,0,0,0,0,0
,,American Indian/Alaska Native,5,4,1,0,5,4,1,0,0,0,0,0,0,0,0,0,0,0,0,0,0,0,0,0,0,0,0,0
,,Pacific Islander,3,2,1,0,2,1,1,0,2,2,0,0,1,1,0,0,1,1,0,0,0,0,0,0,0,0,0,0
,,Multiracial,3,2,1,0,3,2,1,0,1,1,0,0,1,1,0,0,0,0,0,0,0,0,0,0,0,0,0,0
,South Carolina,All Ethnicities,5383,2839,2544,0,5086,2671,2415,0,3210,1918,1292,0,1413,1016,397,0,760,542,218,0,736,483,253,0,51,33,18,0
,,White,3876,2012,1864,0,3711,1917,1794,0,2231,1316,915,0,1023,724,299,0,555,386,169,0,463,300,163,0,31,19,12,0
,,Black,1301,696,605,0,1180,630,550,0,853,505,348,0,325,236,89,0,174,132,42,0,239,156,83,0,19,14,5,0
,,Hispanic,134,94,40,0,127,90,37,0,94,74,20,0,53,47,6,0,24,20,4,0,26,21,5,0,0,0,0,0
,,Unknown,3,2,1,0,3,2,1,0,0,0,0,0,0,0,0,0,1,0,1,0,0,0,0,0,0,0,0,0
,,Asian,43,26,17,0,40,24,16,0,21,17,4,0,6,6,0,0,4,3,1,0,5,4,1,0,0,0,0,0
,,American Indian/Alaska Native,5,2,3,0,5,2,3,0,2,0,2,0,2,0,2,0,1,0,1,0,1,0,1,0,1,0,1,0
,,Pacific Islander,6,1,5,0,6,1,5,0,1,1,0,0,1,1,0,0,1,1,0,0,0,0,0,0,0,0,0,0
,,Multiracial,15,6,9,0,14,5,9,0,8,5,3,0,3,2,1,0,0,0,0,0,2,2,0,0,0,0,0,0
,South Dakota,All Ethnicities,1111,558,553,0,1066,531,535,0,505,297,208,0,202,130,72,0,233,139,94,0,124,70,54,0,16,10,6,0
,,White,981,486,495,0,945,465,480,0,438,250,188,0,172,111,61,0,203,118,85,0,104,57,47,0,15,9,6,0
,,Black,13,9,4,0,10,7,3,0,11,7,4,0,7,4,3,0,3,0,3,0,7,4,3,0,1,1,0,0
,,Hispanic,20,10,10,0,19,9,10,0,7,6,1,0,2,2,0,0,5,5,0,0,4,3,1,0,0,0,0,0
,,Asian,5,3,2,0,5,3,2,0,2,2,0,0,0,0,0,0,0,0,0,0,0,0,0,0,0,0,0,0
,,American Indian/Alaska Native,81,45,36,0,76,42,34,0,43,29,14,0,21,13,8,0,20,15,5,0,9,6,3,0,0,0,0,0
,,Pacific Islander,2,1,1,0,2,1,1,0,2,1,1,0,0,0,0,0,2,1,1,0,0,0,0,0,0,0,0,0
,,Multiracial,9,4,5,0,9,4,5,0,2,2,0,0,0,0,0,0,0,0,0,0,0,0,0,0,0,0,0,0
,State unassigned,All Ethnicities,7828,4233,3594,1,7280,3915,3364,1,2596,1639,957,0,1279,937,342,0,640,457,183,0,477,316,161,0,26,11,15,0
,,White,3415,1847,1568,0,3125,1675,1450,0,1273,757,516,0,625,423,202,0,285,183,102,0,205,116,89,0,5,3,2,0
,,,,,,,,,,,,,,,,,,,,,,,,,,,,,,
,,,,,,,,,,,,,,,,,,,,,,,,,,,,,,
,,Black,745,442,303,0,692,412,280,0,285,188,97,0,132,106,26,0,66,53,13,0,56,45,11,0,6,1,5,0
,,Hispanic,2457,1362,1095,0,2299,1270,1029,0,779,557,222,0,428,352,76,0,229,185,44,0,170,131,39,0,10,5,5,0
,,Unknown,195,94,100,1,187,90,96,1,99,54,45,0,48,30,18,0,34,19,15,0,14,7,7,0,3,2,1,0
,,Asian,831,396,435,0,804,380,424,0,129,66,63,0,36,16,20,0,21,13,8,0,28,15,13,0,2,0,2,0
,,American Indian/Alaska Native,16,7,9,0,15,7,8,0,4,2,2,0,2,2,0,0,1,1,0,0,1,1,0,0,0,0,0,0
,,Pacific Islander,107,49,58,0,99,48,51,0,10,2,8,0,1,1,0,0,0,0,0,0,3,1,2,0,0,0,0,0
,,Multiracial,62,36,26,0,59,33,26,0,17,13,4,0,7,7,0,0,4,3,1,0,0,0,0,0,0,0,0,0
,Tennessee,All Ethnicities,8081,4151,3930,0,7535,3831,3704,0,4480,2600,1880,0,2090,1427,663,0,1156,766,390,0,974,588,386,0,129,70,59,0
,,White,6494,3265,3229,0,6094,3031,3063,0,3583,2030,1553,0,1674,1119,555,0,901,575,326,0,738,426,312,0,91,46,45,0
,,Black,1285,716,569,0,1162,642,520,0,714,459,255,0,306,230,76,0,195,148,47,0,181,124,57,0,27,16,11,0
,,Hispanic,216,132,84,0,198,122,76,0,139,93,46,0,89,66,23,0,47,36,11,0,44,33,11,0,7,6,1,0
,,Unknown,2,1,1,0,2,1,1,0,1,0,1,0,1,0,1,0,0,0,0,0,0,0,0,0,0,0,0,0
,,Asian,58,22,36,0,56,21,35,0,27,8,19,0,12,7,5,0,8,4,4,0,6,3,3,0,3,2,1,0
,,American Indian/Alaska Native,7,5,2,0,6,5,1,0,5,3,2,0,3,2,1,0,2,1,1,0,0,0,0,0,0,0,0,0
,,Pacific Islander,4,2,2,0,4,2,2,0,4,2,2,0,2,1,1,0,1,0,1,0,3,1,2,0,1,0,1,0
,,Multiracial,15,8,7,0,13,7,6,0,7,5,2,0,3,2,1,0,2,2,0,0,2,1,1,0,0,0,0,0
,Texas,All Ethnicities,28137,14538,13599,0,26064,13368,12696,0,14257,8535,5722,0,6831,4761,2070,0,2616,1826,790,0,3483,2135,1348,0,209,130,79,0
,,White,15640,7943,7697,0,14542,7340,7202,0,8056,4655,3401,0,3801,2586,1215,0,1503,1001,502,0,1785,1062,723,0,95,61,34,0
,,Black,3401,1816,1585,0,2996,1588,1408,0,1994,1187,807,0,870,605,265,0,359,267,92,0,528,321,207,0,36,19,17,0
,,Hispanic,8352,4439,3913,0,7854,4139,3715,0,3855,2514,1341,0,2033,1486,547,0,700,523,177,0,1085,710,375,0,72,48,24,0
,,Unknown,30,18,12,0,28,17,11,0,16,11,5,0,11,7,4,0,2,1,1,0,1,1,0,0,0,0,0,0
,,Asian,517,244,273,0,473,219,254,0,262,133,129,0,86,58,28,0,41,28,13,0,71,35,36,0,5,2,3,0
,,American Indian/Alaska Native,38,21,17,0,35,19,16,0,12,9,3,0,6,5,1,0,2,2,0,0,4,2,2,0,0,0,0,0
,,Pacific Islander,34,13,21,0,33,13,20,0,9,4,5,0,4,2,2,0,1,1,0,0,3,2,1,0,0,0,0,0
,,Multiracial,125,44,81,0,103,33,70,0,53,22,31,0,20,12,8,0,8,3,5,0,6,2,4,0,1,0,1,0
,Utah,All Ethnicities,3496,1831,1665,0,3313,1737,1576,0,1426,861,565,0,703,459,244,0,375,249,126,0,259,156,103,0,13,8,5,0
,,White,3122,1624,1498,0,2957,1541,1416,0,1274,764,510,0,621,398,223,0,341,222,119,0,227,136,91,0,12,7,5,0
,,Black,27,13,14,0,23,10,13,0,15,7,8,0,7,6,1,0,3,2,1,0,4,1,3,0,0,0,0,0
,,Hispanic,248,148,100,0,239,142,97,0,100,71,29,0,58,45,13,0,26,21,5,0,22,16,6,0,1,1,0,0
,,Unknown,1,0,1,0,1,0,1,0,0,0,0,0,0,0,0,0,0,0,0,0,0,0,0,0,0,0,0,0
,,Asian,44,25,19,0,41,24,17,0,21,12,9,0,7,5,2,0,5,4,1,0,4,2,2,0,0,0,0,0
,,American Indian/Alaska Native,19,7,12,0,18,7,11,0,5,3,2,0,5,3,2,0,0,0,0,0,0,0,0,0,0,0,0,0
,,Pacific Islander,18,9,9,0,17,8,9,0,7,2,5,0,4,1,3,0,0,0,0,0,2,1,1,0,0,0,0,0
,,Multiracial,17,5,12,0,17,5,12,0,4,2,2,0,1,1,0,0,0,0,0,0,0,0,0,0,0,0,0,0
,Vermont,All Ethnicities,798,389,409,0,746,359,387,0,350,202,148,0,138,89,49,0,85,55,30,0,62,36,26,0,3,1,2,0
,,White,776,381,395,0,727,353,374,0,343,199,144,0,135,87,48,0,84,55,29,0,60,35,25,0,3,1,2,0
,,Black,11,3,8,0,9,1,8,0,5,2,3,0,2,1,1,0,1,0,1,0,1,0,1,0,0,0,0,0
,,Hispanic,8,5,3,0,8,5,3,0,1,1,0,0,1,1,0,0,0,0,0,0,1,1,0,0,0,0,0,0
,,Unknown,1,0,1,0,1,0,1,0,0,0,0,0,0,0,0,0,0,0,0,0,0,0,0,0,0,0,0,0
,,Asian,1,0,1,0,0,0,0,0,1,0,1,0,0,0,0,0,0,0,0,0,0,0,0,0,0,0,0,0
,,Pacific Islander,1,0,1,0,1,0,1,0,0,0,0,0,0,0,0,0,0,0,0,0,0,0,0,0,0,0,0,0
,,,,,,,,,,,,,,,,,,,,,,,,,,,,,,
,,,,,,,,,,,,,,,,,,,,,,,,,,,,,,
,Virginia,All Ethnicities,10007,5058,4949,0,9398,4706,4692,0,4343,2574,1769,0,1762,1192,570,0,916,610,306,0,922,560,362,0,78,39,39,0
,,White,6997,3533,3464,0,6540,3279,3261,0,3124,1840,1284,0,1263,855,408,0,656,432,224,0,613,362,251,0,44,19,25,0
,,Black,2178,1091,1087,0,2066,1023,1043,0,903,536,367,0,370,250,120,0,163,117,46,0,218,138,80,0,27,16,11,0
,,Hispanic,425,233,192,0,400,214,186,0,168,117,51,0,74,55,19,0,57,37,20,0,47,35,12,0,5,3,2,0
,,Asian,339,166,173,0,326,156,170,0,128,68,60,0,43,25,18,0,33,19,14,0,38,20,18,0,2,1,1,0
,,American Indian/Alaska Native,19,10,9,0,19,10,9,0,5,3,2,0,2,1,1,0,2,1,1,0,2,2,0,0,0,0,0,0
,,Pacific Islander,15,9,6,0,15,9,6,0,3,2,1,0,3,2,1,0,1,1,0,0,2,1,1,0,0,0,0,0
,,Multiracial,34,16,18,0,32,15,17,0,12,8,4,0,7,4,3,0,4,3,1,0,2,2,0,0,0,0,0,0
,Washington,All Ethnicities,6425,3192,3233,0,6193,3069,3124,0,2805,1675,1130,0,1217,805,412,0,723,474,249,0,602,343,259,0,26,13,13,0
,,White,5366,2597,2769,0,5173,2496,2677,0,2311,1353,958,0,988,642,346,0,604,390,214,0,485,274,211,0,18,8,10,0
,,Black,242,142,100,0,230,135,95,0,124,85,39,0,57,41,16,0,34,25,9,0,31,22,9,0,3,2,1,0
,,Hispanic,389,232,157,0,378,226,152,0,182,122,60,0,95,71,24,0,43,30,13,0,42,23,19,0,2,1,1,0
,,Unknown,5,3,2,0,4,2,2,0,4,3,1,0,2,2,0,0,1,1,0,0,0,0,0,0,0,0,0,0
,,Asian,246,122,124,0,235,117,118,0,107,59,48,0,36,21,15,0,23,14,9,0,27,14,13,0,1,0,1,0
,,American Indian/Alaska Native,66,31,35,0,65,30,35,0,33,19,14,0,17,10,7,0,8,5,3,0,11,6,5,0,0,0,0,0
,,Pacific Islander,41,27,14,0,41,27,14,0,17,14,3,0,5,5,0,0,4,4,0,0,0,0,0,0,1,1,0,0
,,Multiracial,70,38,32,0,67,36,31,0,27,20,7,0,17,13,4,0,6,5,1,0,6,4,2,0,1,1,0,0
,West Virginia,All Ethnicities,2429,1218,1211,0,2228,1109,1119,0,1445,805,640,0,495,329,166,0,377,243,134,0,271,158,113,0,42,27,15,0
,,White,2283,1137,1146,0,2097,1040,1057,0,1351,750,601,0,451,303,148,0,350,226,124,0,245,144,101,0,40,26,14,0
,,Black,118,67,51,0,106,57,49,0,76,44,32,0,35,20,15,0,19,11,8,0,20,10,10,0,2,1,1,0
,,Hispanic,19,10,9,0,17,9,8,0,15,9,6,0,7,5,2,0,7,5,2,0,4,3,1,0,0,0,0,0
,,Asian,7,3,4,0,6,2,4,0,3,2,1,0,2,1,1,0,1,1,0,0,2,1,1,0,0,0,0,0
,,Multiracial,2,1,1,0,2,1,1,0,0,0,0,0,0,0,0,0,0,0,0,0,0,0,0,0,0,0,0,0
,Wisconsin,All Ethnicities,9144,4722,4422,0,8686,4479,4207,0,4235,2553,1682,0,1715,1179,536,0,1895,1194,701,0,867,502,365,0,42,26,16,0
,,White,8131,4142,3989,0,7768,3949,3819,0,3685,2206,1479,0,1454,976,478,0,1706,1059,647,0,739,412,327,0,33,19,14,0
,,Black,554,327,227,0,485,294,191,0,350,216,134,0,164,131,33,0,108,79,29,0,84,61,23,0,5,4,1,0
,,Hispanic,286,175,111,0,267,163,104,0,144,104,40,0,72,60,12,0,59,48,11,0,32,24,8,0,3,2,1,0
,,Unknown,2,1,1,0,2,1,1,0,0,0,0,0,0,0,0,0,0,0,0,0,0,0,0,0,0,0,0,0
,,Asian,79,31,48,0,75,27,48,0,33,13,20,0,11,3,8,0,11,1,10,0,9,3,6,0,0,0,0,0
,,American Indian/Alaska Native,63,31,32,0,60,30,30,0,14,9,5,0,6,5,1,0,8,6,2,0,2,2,0,0,0,0,0,0
,,Pacific Islander,4,1,3,0,4,1,3,0,2,0,2,0,2,0,2,0,2,0,2,0,1,0,1,0,0,0,0,0
,,Multiracial,25,14,11,0,25,14,11,0,7,5,2,0,6,4,2,0,1,1,0,0,0,0,0,0,1,1,0,0
,Wyoming,All Ethnicities,686,377,309,0,647,352,295,0,360,231,129,0,184,140,44,0,112,82,30,0,75,47,28,0,1,1,0,0
,,White,643,359,284,0,606,335,271,0,336,218,118,0,171,131,40,0,107,80,27,0,72,45,27,0,1,1,0,0
,,Black,5,4,1,0,5,4,1,0,5,4,1,0,4,4,0,0,0,0,0,0,1,1,0,0,0,0,0,0
,,Hispanic,24,10,14,0,22,9,13,0,13,7,6,0,6,3,3,0,4,2,2,0,1,0,1,0,0,0,0,0
,,Asian,5,1,4,0,5,1,4,0,1,0,1,0,0,0,0,0,0,0,0,0,1,1,0,0,0,0,0,0
,,American Indian/Alaska Native,9,3,6,0,9,3,6,0,5,2,3,0,3,2,1,0,1,0,1,0,0,0,0,0,0,0,0,0
Deceased Donor,All Donor States of Residence,All Ethnicities,222013,132737,89276,0,203365,121685,81680,0,179950,107646,72304,0,78066,53391,24675,0,46502,30885,15617,0,39371,23760,15611,0,3386,1988,1398,0
,,White,156216,91504,64712,0,145100,84961,60139,0,125159,73267,51892,0,53945,36000,17945,0,33316,21306,12010,0,25807,14923,10884,0,2145,1224,921,0
,,Black,31290,19080,12210,0,26758,16438,10320,0,26810,16383,10427,0,10963,7854,3109,0,6472,4773,1699,0,6672,4385,2287,0,655,416,239,0
,,,,,,,,,,,,,,,,,,,,,,,,,,,,,,
,,,,,,,,,,,,,,,,,,,,,,,,,,,,,,
,,Hispanic,26660,17753,8907,0,24351,16296,8055,0,21550,14373,7177,0,10971,8101,2870,0,5389,3947,1442,0,5370,3639,1731,0,476,290,186,0
,,Unknown,217,129,88,0,201,118,83,0,167,102,65,0,83,55,28,0,51,30,21,0,20,11,9,0,4,3,1,0
,,Asian,4645,2460,2185,0,4244,2228,2016,0,3815,2036,1779,0,1153,704,449,0,708,419,289,0,976,466,510,0,55,24,31,0
,,American Indian/Alaska Native,872,532,340,0,817,504,313,0,657,398,259,0,345,235,110,0,198,143,55,0,162,106,56,0,13,7,6,0
,,Pacific Islander,530,313,217,0,488,291,197,0,429,251,178,0,121,76,45,0,90,64,26,0,85,45,40,0,4,2,2,0
,,Multiracial,1583,966,617,0,1406,849,557,0,1363,836,527,0,485,366,119,0,278,203,75,0,279,185,94,0,34,22,12,0
,Alabama,All Ethnicities,3750,2264,1486,0,3452,2079,1373,0,3091,1867,1224,0,1191,853,338,0,602,433,169,0,569,377,192,0,36,22,14,0
,,White,2800,1654,1146,0,2621,1542,1079,0,2271,1345,926,0,879,613,266,0,440,301,139,0,398,253,145,0,24,14,10,0
,,Black,874,553,321,0,760,483,277,0,759,475,284,0,275,211,64,0,150,122,28,0,158,114,44,0,9,6,3,0
,,Hispanic,42,36,6,0,40,34,6,0,35,31,4,0,25,22,3,0,7,7,0,0,8,7,1,0,2,2,0,0
,,Unknown,2,1,1,0,2,1,1,0,1,0,1,0,0,0,0,0,0,0,0,0,0,0,0,0,0,0,0,0
,,Asian,22,15,7,0,20,14,6,0,17,11,6,0,7,4,3,0,4,2,2,0,3,2,1,0,1,0,1,0
,,American Indian/Alaska Native,2,1,1,0,2,1,1,0,1,1,0,0,1,1,0,0,1,1,0,0,0,0,0,0,0,0,0,0
,,Pacific Islander,1,0,1,0,0,0,0,0,1,0,1,0,1,0,1,0,0,0,0,0,0,0,0,0,0,0,0,0
,,Multiracial,7,4,3,0,7,4,3,0,6,4,2,0,3,2,1,0,0,0,0,0,2,1,1,0,0,0,0,0
,Alaska,All Ethnicities,622,395,227,0,604,381,223,0,490,317,173,0,209,165,44,0,150,121,29,0,128,85,43,0,1,1,0,0
,,White,453,290,163,0,437,277,160,0,357,229,128,0,154,119,35,0,107,85,22,0,94,62,32,0,0,0,0,0
,,Black,23,16,7,0,23,16,7,0,20,14,6,0,7,4,3,0,8,6,2,0,6,4,2,0,0,0,0,0
,,Hispanic,14,11,3,0,13,10,3,0,11,8,3,0,7,6,1,0,2,1,1,0,2,1,1,0,0,0,0,0
,,Asian,20,10,10,0,20,10,10,0,16,9,7,0,7,6,1,0,3,3,0,0,7,3,4,0,0,0,0,0
,,American Indian/Alaska Native,104,63,41,0,103,63,40,0,78,52,26,0,32,28,4,0,29,25,4,0,17,14,3,0,1,1,0,0
,,Pacific Islander,5,3,2,0,5,3,2,0,5,3,2,0,0,0,0,0,0,0,0,0,2,1,1,0,0,0,0,0
,,Multiracial,3,2,1,0,3,2,1,0,3,2,1,0,2,2,0,0,1,1,0,0,0,0,0,0,0,0,0,0
,Arizona,All Ethnicities,3771,2350,1421,0,3593,2245,1348,0,3106,1953,1153,0,1339,954,385,0,687,474,213,0,729,465,264,0,45,34,11,0
,,White,2598,1567,1031,0,2485,1504,981,0,2115,1289,826,0,884,616,268,0,451,303,148,0,469,287,182,0,23,18,5,0
,,Black,196,120,76,0,172,104,68,0,174,109,65,0,66,45,21,0,30,17,13,0,43,26,17,0,1,1,0,0
,,Hispanic,832,576,256,0,795,551,244,0,706,488,218,0,331,254,77,0,184,138,46,0,182,133,49,0,19,13,6,0
,,Unknown,2,2,0,0,2,2,0,0,1,1,0,0,0,0,0,0,1,1,0,0,0,0,0,0,0,0,0,0
,,Asian,42,21,21,0,41,21,20,0,39,19,20,0,18,10,8,0,7,4,3,0,13,4,9,0,0,0,0,0
,,American Indian/Alaska Native,72,44,28,0,69,43,26,0,47,30,17,0,25,18,7,0,10,8,2,0,18,11,7,0,1,1,0,0
,,Pacific Islander,5,2,3,0,5,2,3,0,3,1,2,0,1,0,1,0,0,0,0,0,0,0,0,0,0,0,0,0
,,Multiracial,24,18,6,0,24,18,6,0,21,16,5,0,14,11,3,0,4,3,1,0,4,4,0,0,1,1,0,0
,Arkansas,All Ethnicities,2056,1212,844,0,1905,1122,783,0,1741,1023,718,0,811,565,246,0,418,278,140,0,366,193,173,0,56,33,23,0
,,White,1667,957,710,0,1573,897,676,0,1413,809,604,0,651,448,203,0,338,215,123,0,287,145,142,0,42,24,18,0
,,Black,308,199,109,0,257,172,85,0,267,175,92,0,127,94,33,0,64,51,13,0,67,41,26,0,13,8,5,0
,,Hispanic,59,44,15,0,54,41,13,0,42,29,13,0,23,17,6,0,14,10,4,0,8,6,2,0,1,1,0,0
,,Asian,12,6,6,0,11,6,5,0,12,6,6,0,5,2,3,0,2,2,0,0,3,1,2,0,0,0,0,0
,,American Indian/Alaska Native,2,1,1,0,2,1,1,0,2,1,1,0,0,0,0,0,0,0,0,0,1,0,1,0,0,0,0,0
,,Pacific Islander,4,2,2,0,4,2,2,0,4,2,2,0,1,1,0,0,0,0,0,0,0,0,0,0,0,0,0,0
,,Multiracial,4,3,1,0,4,3,1,0,1,1,0,0,4,3,1,0,0,0,0,0,0,0,0,0,0,0,0,0
,California,All Ethnicities,22206,13747,8459,0,20749,12847,7902,0,18029,11199,6830,0,8556,6005,2551,0,4221,2908,1313,0,4350,2703,1647,0,156,86,70,0
,,,,,,,,,,,,,,,,,,,,,,,,,,,,,,
,,,,,,,,,,,,,,,,,,,,,,,,,,,,,,
,,White,11407,6747,4660,0,10776,6354,4422,0,9150,5429,3721,0,4219,2837,1382,0,2121,1387,734,0,1890,1066,824,0,56,31,25,0
,,Black,1926,1200,726,0,1736,1082,654,0,1671,1049,622,0,725,536,189,0,370,273,97,0,433,308,125,0,16,9,7,0
,,Hispanic,6886,4699,2187,0,6403,4401,2002,0,5558,3801,1757,0,3071,2292,779,0,1453,1081,372,0,1595,1103,492,0,72,41,31,0
,,Unknown,9,5,4,0,7,4,3,0,8,5,3,0,4,3,1,0,2,1,1,0,2,1,1,0,0,0,0,0
,,Asian,1527,828,699,0,1407,758,649,0,1266,695,571,0,375,227,148,0,200,118,82,0,337,175,162,0,9,3,6,0
,,American Indian/Alaska Native,76,50,26,0,71,47,24,0,55,35,20,0,33,25,8,0,16,11,5,0,16,9,7,0,1,1,0,0
,,Pacific Islander,139,74,65,0,125,64,61,0,115,62,53,0,42,23,19,0,21,13,8,0,38,20,18,0,1,1,0,0
,,Multiracial,236,144,92,0,224,137,87,0,206,123,83,0,87,62,25,0,38,24,14,0,39,21,18,0,1,0,1,0
,Colorado,All Ethnicities,2937,1739,1198,0,2753,1628,1125,0,2404,1439,965,0,1210,827,383,0,756,476,280,0,489,287,202,0,41,22,19,0
,,White,2284,1330,954,0,2159,1258,901,0,1867,1101,766,0,945,640,305,0,612,380,232,0,374,220,154,0,32,17,15,0
,,Black,149,90,59,0,125,74,51,0,135,82,53,0,64,45,19,0,34,21,13,0,34,19,15,0,0,0,0,0
,,Hispanic,424,273,151,0,397,255,142,0,335,216,119,0,174,125,49,0,101,69,32,0,66,39,27,0,8,5,3,0
,,Unknown,1,1,0,0,1,1,0,0,1,1,0,0,1,1,0,0,0,0,0,0,0,0,0,0,0,0,0,0
,,Asian,56,28,28,0,52,26,26,0,47,26,21,0,13,6,7,0,6,4,2,0,8,3,5,0,0,0,0,0
,,American Indian/Alaska Native,21,15,6,0,18,13,5,0,17,11,6,0,13,10,3,0,3,2,1,0,7,6,1,0,1,0,1,0
,,Pacific Islander,2,2,0,0,1,1,0,0,2,2,0,0,0,0,0,0,0,0,0,0,0,0,0,0,0,0,0,0
,Connecticut,All Ethnicities,1966,1223,743,0,1846,1146,700,0,1546,949,597,0,725,511,214,0,353,241,112,0,271,185,86,0,21,13,8,0
,,White,1474,899,575,0,1403,850,553,0,1127,670,457,0,515,345,170,0,250,157,93,0,184,124,60,0,11,6,5,0
,,Black,194,128,66,0,171,116,55,0,168,111,57,0,71,55,16,0,35,29,6,0,32,23,9,0,3,2,1,0
,,Hispanic,260,170,90,0,238,156,82,0,221,146,75,0,120,95,25,0,59,47,12,0,45,29,16,0,6,5,1,0
,,Unknown,2,1,1,0,2,1,1,0,0,0,0,0,2,1,1,0,1,1,0,0,0,0,0,0,0,0,0,0
,,Asian,22,15,7,0,21,15,6,0,19,14,5,0,10,10,0,0,5,4,1,0,6,5,1,0,0,0,0,0
,,American Indian/Alaska Native,3,2,1,0,3,2,1,0,2,2,0,0,2,2,0,0,2,2,0,0,2,2,0,0,0,0,0,0
,,Pacific Islander,1,1,0,0,1,1,0,0,0,0,0,0,1,1,0,0,0,0,0,0,0,0,0,0,0,0,0,0
,,Multiracial,10,7,3,0,7,5,2,0,9,6,3,0,4,2,2,0,1,1,0,0,2,2,0,0,1,0,1,0
,Delaware,All Ethnicities,1027,614,413,0,940,559,381,0,831,491,340,0,328,222,106,0,203,138,65,0,199,126,73,0,13,10,3,0
,,White,805,478,327,0,754,444,310,0,635,372,263,0,251,165,86,0,146,96,50,0,143,86,57,0,5,4,1,0
,,Black,164,98,66,0,133,80,53,0,147,88,59,0,52,37,15,0,38,27,11,0,40,28,12,0,6,4,2,0
,,Hispanic,41,29,12,0,38,27,11,0,35,25,10,0,19,16,3,0,14,11,3,0,11,9,2,0,1,1,0,0
,,Asian,13,7,6,0,11,6,5,0,10,4,6,0,3,2,1,0,2,2,0,0,3,2,1,0,0,0,0,0
,,Multiracial,4,2,2,0,4,2,2,0,4,2,2,0,3,2,1,0,3,2,1,0,2,1,1,0,1,1,0,0
,District of Columbia,All Ethnicities,560,343,217,0,502,304,198,0,455,284,171,0,185,138,47,0,156,116,40,0,111,67,44,0,8,6,2,0
,,White,81,52,29,0,77,49,28,0,65,45,20,0,24,16,8,0,21,14,7,0,17,10,7,0,1,1,0,0
,,Black,445,267,178,0,394,233,161,0,361,218,143,0,146,109,37,0,122,92,30,0,85,51,34,0,6,5,1,0
,,Hispanic,30,22,8,0,28,20,8,0,25,19,6,0,12,12,0,0,11,9,2,0,7,5,2,0,0,0,0,0
,,Asian,3,1,2,0,2,1,1,0,3,1,2,0,3,1,2,0,2,1,1,0,2,1,1,0,1,0,1,0
,,Multiracial,1,1,0,0,1,1,0,0,1,1,0,0,0,0,0,0,0,0,0,0,0,0,0,0,0,0,0,0
,Florida,All Ethnicities,14567,8660,5907,0,13009,7769,5240,0,11843,7085,4758,0,4587,3128,1459,0,2680,1804,876,0,2389,1387,1002,0,388,233,155,0
,,White,10085,5886,4199,0,9066,5328,3738,0,8038,4708,3330,0,3047,2048,999,0,1706,1109,597,0,1520,847,673,0,194,111,83,0
,,Black,2065,1275,790,0,1749,1097,652,0,1818,1128,690,0,709,511,198,0,457,337,120,0,435,285,150,0,84,57,27,0
,,Hispanic,2135,1346,789,0,1946,1215,731,0,1751,1119,632,0,751,513,238,0,472,328,144,0,379,229,150,0,102,60,42,0
,,,,,,,,,,,,,,,,,,,,,,,,,,,,,,
,,,,,,,,,,,,,,,,,,,,,,,,,,,,,,
,,Unknown,20,12,8,0,16,8,8,0,17,10,7,0,5,4,1,0,3,1,2,0,2,1,1,0,1,1,0,0
,,Asian,168,96,72,0,146,81,65,0,140,82,58,0,45,31,14,0,20,15,5,0,39,17,22,0,4,2,2,0
,,American Indian/Alaska Native,17,7,10,0,17,7,10,0,16,6,10,0,8,4,4,0,6,2,4,0,2,1,1,0,0,0,0,0
,,Pacific Islander,14,7,7,0,11,5,6,0,11,5,6,0,2,2,0,0,1,1,0,0,1,0,1,0,0,0,0,0
,,Multiracial,63,31,32,0,58,28,30,0,52,27,25,0,20,15,5,0,15,11,4,0,11,7,4,0,3,2,1,0
,Georgia,All Ethnicities,6486,3706,2780,0,5610,3173,2437,0,5469,3152,2317,0,2366,1600,766,0,979,691,288,0,1168,681,487,0,117,65,52,0
,,White,4132,2331,1801,0,3678,2055,1623,0,3423,1954,1469,0,1527,1008,519,0,650,434,216,0,680,389,291,0,69,36,33,0
,,Black,1939,1117,822,0,1563,888,675,0,1694,982,712,0,652,463,189,0,251,199,52,0,394,237,157,0,35,23,12,0
,,Hispanic,309,202,107,0,275,181,94,0,263,169,94,0,152,107,45,0,64,47,17,0,69,43,26,0,7,2,5,0
,,Unknown,2,2,0,0,2,2,0,0,2,2,0,0,0,0,0,0,0,0,0,0,0,0,0,0,0,0,0,0
,,Asian,82,39,43,0,73,33,40,0,68,32,36,0,22,11,11,0,11,8,3,0,22,10,12,0,2,1,1,0
,,American Indian/Alaska Native,1,1,0,0,1,1,0,0,1,1,0,0,0,0,0,0,0,0,0,0,0,0,0,0,0,0,0,0
,,Pacific Islander,3,1,2,0,2,1,1,0,3,1,2,0,2,1,1,0,0,0,0,0,2,1,1,0,0,0,0,0
,,Multiracial,18,13,5,0,16,12,4,0,15,11,4,0,11,10,1,0,3,3,0,0,1,1,0,0,4,3,1,0
,Hawaii,All Ethnicities,791,515,276,0,762,499,263,0,576,375,201,0,69,56,13,0,109,84,25,0,32,15,17,0,1,1,0,0
,,White,260,180,80,0,255,178,77,0,165,118,47,0,29,24,5,0,39,33,6,0,13,9,4,0,0,0,0,0
,,Black,8,6,2,0,7,6,1,0,5,3,2,0,0,0,0,0,1,0,1,0,1,0,1,0,0,0,0,0
,,Hispanic,16,14,2,0,16,14,2,0,12,10,2,0,1,1,0,0,3,2,1,0,1,1,0,0,0,0,0,0
,,Unknown,3,2,1,0,3,2,1,0,3,2,1,0,0,0,0,0,0,0,0,0,0,0,0,0,0,0,0,0
,,Asian,264,148,116,0,250,141,109,0,207,118,89,0,15,13,2,0,27,18,9,0,10,2,8,0,1,1,0,0
,,American Indian/Alaska Native,2,2,0,0,2,2,0,0,0,0,0,0,1,1,0,0,0,0,0,0,0,0,0,0,0,0,0,0
,,Pacific Islander,194,134,60,0,187,129,58,0,146,101,45,0,21,15,6,0,32,26,6,0,7,3,4,0,0,0,0,0
,,Multiracial,44,29,15,0,42,27,15,0,38,23,15,0,2,2,0,0,7,5,2,0,0,0,0,0,0,0,0,0
,Idaho,All Ethnicities,930,577,353,0,883,546,337,0,753,471,282,0,372,257,115,0,201,138,63,0,148,99,49,0,15,6,9,0
,,White,844,520,324,0,803,493,310,0,685,425,260,0,335,232,103,0,183,128,55,0,131,87,44,0,11,5,6,0
,,Black,11,7,4,0,11,7,4,0,10,6,4,0,4,2,2,0,5,3,2,0,1,1,0,0,1,0,1,0
,,Hispanic,61,41,20,0,55,37,18,0,46,33,13,0,25,18,7,0,10,6,4,0,13,10,3,0,2,1,1,0
,,Asian,2,2,0,0,2,2,0,0,2,2,0,0,0,0,0,0,0,0,0,0,1,1,0,0,0,0,0,0
,,American Indian/Alaska Native,8,4,4,0,8,4,4,0,6,2,4,0,6,4,2,0,2,0,2,0,1,0,1,0,1,0,1,0
,,Pacific Islander,1,1,0,0,1,1,0,0,1,1,0,0,1,1,0,0,0,0,0,0,0,0,0,0,0,0,0,0
,,Multiracial,3,2,1,0,3,2,1,0,3,2,1,0,1,0,1,0,1,1,0,0,1,0,1,0,0,0,0,0
,Illinois,All Ethnicities,9630,5875,3755,0,8705,5330,3375,0,7468,4527,2941,0,3052,2090,962,0,2651,1714,937,0,1846,1140,706,0,139,88,51,0
,,White,6305,3723,2582,0,5823,3432,2391,0,4730,2755,1975,0,1911,1228,683,0,1702,1011,691,0,1095,623,472,0,80,50,30,0
,,Black,2187,1381,806,0,1854,1193,661,0,1862,1173,689,0,717,547,170,0,617,459,158,0,488,341,147,0,42,29,13,0
,,Hispanic,935,661,274,0,855,609,246,0,721,517,204,0,376,281,95,0,295,221,74,0,218,159,59,0,15,8,7,0
,,Unknown,2,1,1,0,1,1,0,0,2,1,1,0,0,0,0,0,1,1,0,0,0,0,0,0,0,0,0,0
,,Asian,167,91,76,0,144,80,64,0,129,71,58,0,37,27,10,0,29,17,12,0,41,17,24,0,1,0,1,0
,,American Indian/Alaska Native,9,5,4,0,7,4,3,0,6,2,4,0,2,1,1,0,2,1,1,0,2,0,2,0,0,0,0,0
,,Pacific Islander,11,6,5,0,10,6,4,0,8,4,4,0,1,1,0,0,3,2,1,0,0,0,0,0,0,0,0,0
,,Multiracial,14,7,7,0,11,5,6,0,10,4,6,0,8,5,3,0,2,2,0,0,2,0,2,0,1,1,0,0
,Indiana,All Ethnicities,4736,2810,1926,0,4386,2601,1785,0,4062,2405,1657,0,1950,1341,609,0,1217,796,421,0,1002,595,407,0,201,122,79,0
,,,,,,,,,,,,,,,,,,,,,,,,,,,,,,
,,,,,,,,,,,,,,,,,,,,,,,,,,,,,,
,,White,3966,2328,1638,0,3708,2174,1534,0,3387,1981,1406,0,1623,1111,512,0,994,631,363,0,817,466,351,0,161,93,68,0
,,Black,580,364,216,0,499,316,183,0,513,322,191,0,247,179,68,0,166,127,39,0,145,98,47,0,31,23,8,0
,,Hispanic,145,93,52,0,138,88,50,0,123,82,41,0,67,43,24,0,45,31,14,0,33,25,8,0,8,5,3,0
,,Unknown,1,1,0,0,1,1,0,0,1,1,0,0,0,0,0,0,0,0,0,0,0,0,0,0,0,0,0,0
,,Asian,34,19,15,0,31,18,13,0,30,16,14,0,8,5,3,0,11,6,5,0,7,6,1,0,1,1,0,0
,,American Indian/Alaska Native,3,1,2,0,3,1,2,0,2,0,2,0,1,0,1,0,0,0,0,0,0,0,0,0,0,0,0,0
,,Pacific Islander,3,1,2,0,3,1,2,0,3,1,2,0,1,1,0,0,1,1,0,0,0,0,0,0,0,0,0,0
,,Multiracial,4,3,1,0,3,2,1,0,3,2,1,0,3,2,1,0,0,0,0,0,0,0,0,0,0,0,0,0
,Iowa,All Ethnicities,1949,1158,791,0,1847,1100,747,0,1623,956,667,0,719,466,253,0,559,354,205,0,348,189,159,0,38,16,22,0
,,White,1811,1065,746,0,1724,1017,707,0,1508,882,626,0,662,425,237,0,527,329,198,0,313,165,148,0,29,13,16,0
,,Black,69,51,18,0,60,45,15,0,58,41,17,0,32,26,6,0,16,15,1,0,17,16,1,0,5,2,3,0
,,Hispanic,46,33,13,0,41,30,11,0,38,26,12,0,19,13,6,0,11,8,3,0,11,7,4,0,3,1,2,0
,,Asian,20,6,14,0,20,6,14,0,18,6,12,0,5,1,4,0,4,1,3,0,6,0,6,0,1,0,1,0
,,American Indian/Alaska Native,3,3,0,0,2,2,0,0,1,1,0,0,1,1,0,0,1,1,0,0,1,1,0,0,0,0,0,0
,Kansas,All Ethnicities,2568,1580,988,0,2378,1472,906,0,2111,1285,826,0,937,650,287,0,658,431,227,0,496,308,188,0,51,30,21,0
,,White,2138,1309,829,0,1985,1221,764,0,1740,1058,682,0,763,536,227,0,545,357,188,0,385,232,153,0,42,24,18,0
,,Black,174,104,70,0,155,94,61,0,158,93,65,0,65,42,23,0,39,25,14,0,45,31,14,0,3,3,0,0
,,Hispanic,214,144,70,0,198,135,63,0,175,114,61,0,91,61,30,0,62,41,21,0,54,37,17,0,3,2,1,0
,,Unknown,1,1,0,0,1,1,0,0,1,1,0,0,0,0,0,0,0,0,0,0,0,0,0,0,0,0,0,0
,,Asian,26,12,14,0,25,12,13,0,24,11,13,0,10,6,4,0,5,3,2,0,5,2,3,0,1,0,1,0
,,American Indian/Alaska Native,12,9,3,0,11,8,3,0,10,7,3,0,6,4,2,0,4,4,0,0,6,5,1,0,1,1,0,0
,,Pacific Islander,1,0,1,0,1,0,1,0,1,0,1,0,1,0,1,0,1,0,1,0,0,0,0,0,0,0,0,0
,,Multiracial,2,1,1,0,2,1,1,0,2,1,1,0,1,1,0,0,2,1,1,0,1,1,0,0,1,0,1,0
,Kentucky,All Ethnicities,2927,1789,1138,0,2734,1656,1078,0,2446,1499,947,0,1091,753,338,0,699,457,242,0,541,336,205,0,47,23,24,0
,,White,2606,1583,1023,0,2440,1473,967,0,2162,1319,843,0,968,664,304,0,611,390,221,0,466,284,182,0,40,18,22,0
,,Black,256,166,90,0,234,147,87,0,225,142,83,0,91,68,23,0,66,51,15,0,62,44,18,0,6,4,2,0
,,Hispanic,43,29,14,0,39,26,13,0,40,27,13,0,23,16,7,0,15,11,4,0,7,5,2,0,0,0,0,0
,,Asian,11,7,4,0,11,7,4,0,10,7,3,0,4,3,1,0,3,3,0,0,3,2,1,0,0,0,0,0
,,American Indian/Alaska Native,3,1,2,0,2,0,2,0,2,1,1,0,1,0,1,0,1,0,1,0,0,0,0,0,0,0,0,0
,,Pacific Islander,2,0,2,0,2,0,2,0,1,0,1,0,1,0,1,0,0,0,0,0,0,0,0,0,0,0,0,0
,,Multiracial,6,3,3,0,6,3,3,0,6,3,3,0,3,2,1,0,3,2,1,0,3,1,2,0,1,1,0,0
,Louisiana,All Ethnicities,4044,2461,1583,0,3573,2195,1378,0,3613,2207,1406,0,1498,1070,428,0,984,680,304,0,820,513,307,0,75,46,29,0
,,White,2635,1606,1029,0,2414,1479,935,0,2356,1449,907,0,1026,738,288,0,698,474,224,0,530,326,204,0,46,28,18,0
,,Black,1281,772,509,0,1050,645,405,0,1151,688,463,0,415,295,120,0,262,190,72,0,269,175,94,0,28,18,10,0
,,Hispanic,87,55,32,0,70,45,25,0,72,47,25,0,42,28,14,0,13,9,4,0,17,11,6,0,1,0,1,0
,,Unknown,1,1,0,0,1,1,0,0,1,1,0,0,1,1,0,0,0,0,0,0,0,0,0,0,0,0,0,0
,,Asian,33,21,12,0,31,19,12,0,29,18,11,0,12,6,6,0,9,5,4,0,4,1,3,0,0,0,0,0
,,American Indian/Alaska Native,5,4,1,0,5,4,1,0,2,2,0,0,2,2,0,0,2,2,0,0,0,0,0,0,0,0,0,0
,,Multiracial,2,2,0,0,2,2,0,0,2,2,0,0,0,0,0,0,0,0,0,0,0,0,0,0,0,0,0,0
,Maine,All Ethnicities,934,578,356,0,888,551,337,0,718,443,275,0,336,233,103,0,207,132,75,0,126,80,46,0,17,8,9,0
,,White,904,557,347,0,861,532,329,0,691,425,266,0,322,223,99,0,198,126,72,0,122,79,43,0,15,7,8,0
,,,,,,,,,,,,,,,,,,,,,,,,,,,,,,
,,,,,,,,,,,,,,,,,,,,,,,,,,,,,,
,,Black,12,10,2,0,9,8,1,0,11,9,2,0,4,3,1,0,4,4,0,0,1,0,1,0,0,0,0,0
,,Hispanic,11,6,5,0,11,6,5,0,9,4,5,0,7,4,3,0,4,1,3,0,2,1,1,0,2,1,1,0
,,Asian,4,2,2,0,4,2,2,0,4,2,2,0,1,1,0,0,1,1,0,0,1,0,1,0,0,0,0,0
,,Multiracial,3,3,0,0,3,3,0,0,3,3,0,0,2,2,0,0,0,0,0,0,0,0,0,0,0,0,0,0
,Maryland,All Ethnicities,4570,2684,1886,0,4184,2456,1728,0,3787,2238,1549,0,1436,966,470,0,1161,774,387,0,1004,611,393,0,54,29,25,0
,,White,2832,1645,1187,0,2651,1541,1110,0,2298,1335,963,0,851,552,299,0,698,438,260,0,556,332,224,0,31,17,14,0
,,Black,1428,843,585,0,1234,729,505,0,1228,734,494,0,482,336,146,0,375,275,100,0,355,219,136,0,15,9,6,0
,,Hispanic,180,127,53,0,177,124,53,0,154,111,43,0,73,59,14,0,61,45,16,0,57,41,16,0,7,2,5,0
,,Asian,109,58,51,0,102,51,51,0,90,49,41,0,26,17,9,0,20,12,8,0,33,17,16,0,1,1,0,0
,,American Indian/Alaska Native,4,4,0,0,4,4,0,0,2,2,0,0,0,0,0,0,0,0,0,0,0,0,0,0,0,0,0,0
,,Pacific Islander,5,3,2,0,5,3,2,0,5,3,2,0,1,0,1,0,3,2,1,0,1,1,0,0,0,0,0,0
,,Multiracial,12,4,8,0,11,4,7,0,10,4,6,0,3,2,1,0,4,2,2,0,2,1,1,0,0,0,0,0
,Massachusetts,All Ethnicities,3717,2252,1465,0,3476,2099,1377,0,2761,1654,1107,0,1242,822,420,0,614,416,198,0,502,304,198,0,33,20,13,0
,,White,3061,1809,1252,0,2874,1690,1184,0,2235,1303,932,0,977,629,348,0,476,311,165,0,387,228,159,0,22,13,9,0
,,Black,215,146,69,0,193,133,60,0,169,113,56,0,83,58,25,0,39,33,6,0,40,29,11,0,3,2,1,0
,,Hispanic,361,250,111,0,335,233,102,0,287,199,88,0,157,115,42,0,84,63,21,0,62,41,21,0,6,3,3,0
,,Unknown,4,4,0,0,4,4,0,0,2,2,0,0,2,2,0,0,1,1,0,0,0,0,0,0,0,0,0,0
,,Asian,55,27,28,0,50,24,26,0,49,23,26,0,13,9,4,0,11,5,6,0,13,6,7,0,1,1,0,0
,,American Indian/Alaska Native,5,5,0,0,5,5,0,0,4,4,0,0,3,3,0,0,1,1,0,0,0,0,0,0,0,0,0,0
,,Multiracial,16,11,5,0,15,10,5,0,15,10,5,0,7,6,1,0,2,2,0,0,0,0,0,0,1,1,0,0
,Michigan,All Ethnicities,7804,4563,3241,0,7232,4242,2990,0,5822,3423,2399,0,2548,1689,859,0,1425,947,478,0,1548,886,662,0,153,86,67,0
,,White,6299,3655,2644,0,5926,3443,2483,0,4605,2678,1927,0,2009,1322,687,0,1146,741,405,0,1183,656,527,0,108,56,52,0
,,Black,1210,746,464,0,1038,651,387,0,986,615,371,0,431,303,128,0,237,177,60,0,292,189,103,0,40,29,11,0
,,Hispanic,199,122,77,0,175,108,67,0,164,101,63,0,80,50,30,0,29,21,8,0,47,32,15,0,3,1,2,0
,,Asian,65,23,42,0,62,23,39,0,49,19,30,0,20,9,11,0,9,6,3,0,22,6,16,0,2,0,2,0
,,American Indian/Alaska Native,16,10,6,0,16,10,6,0,9,6,3,0,2,1,1,0,1,1,0,0,1,0,1,0,0,0,0,0
,,Pacific Islander,7,4,3,0,7,4,3,0,5,3,2,0,3,3,0,0,2,1,1,0,1,1,0,0,0,0,0,0
,,Multiracial,8,3,5,0,8,3,5,0,4,1,3,0,3,1,2,0,1,0,1,0,2,2,0,0,0,0,0,0
,Minnesota,All Ethnicities,3396,1996,1400,0,3185,1870,1315,0,2866,1679,1187,0,1304,829,475,0,1383,849,534,0,686,403,283,0,86,52,34,0
,,White,3082,1805,1277,0,2903,1703,1200,0,2592,1511,1081,0,1170,741,429,0,1262,771,491,0,610,357,253,0,78,49,29,0
,,Black,137,93,44,0,122,80,42,0,123,87,36,0,58,44,14,0,59,42,17,0,35,26,9,0,1,1,0,0
,,Hispanic,87,53,34,0,81,49,32,0,76,45,31,0,40,26,14,0,31,21,10,0,17,8,9,0,2,1,1,0
,,Unknown,1,1,0,0,1,1,0,0,1,1,0,0,1,1,0,0,1,1,0,0,0,0,0,0,0,0,0,0
,,Asian,41,22,19,0,35,18,17,0,33,16,17,0,15,8,7,0,12,7,5,0,15,6,9,0,2,0,2,0
,,American Indian/Alaska Native,39,18,21,0,36,17,19,0,33,16,17,0,15,6,9,0,13,5,8,0,6,4,2,0,1,0,1,0
,,Pacific Islander,2,1,1,0,2,1,1,0,2,1,1,0,1,1,0,0,2,1,1,0,1,1,0,0,0,0,0,0
,,Multiracial,7,3,4,0,5,1,4,0,6,2,4,0,4,2,2,0,3,1,2,0,2,1,1,0,2,1,1,0
,Mississippi,All Ethnicities,2122,1240,882,0,1955,1134,821,0,1694,1006,688,0,720,479,241,0,395,258,137,0,313,197,116,0,63,36,27,0
,,White,1439,809,630,0,1349,751,598,0,1129,647,482,0,487,308,179,0,272,169,103,0,177,109,68,0,41,22,19,0
,,Black,635,397,238,0,563,352,211,0,529,334,195,0,214,155,59,0,117,84,33,0,130,83,47,0,20,13,7,0
,,Hispanic,29,20,9,0,25,18,7,0,22,14,8,0,12,10,2,0,3,3,0,0,3,3,0,0,0,0,0,0
,,,,,,,,,,,,,,,,,,,,,,,,,,,,,,
,,,,,,,,,,,,,,,,,,,,,,,,,,,,,,
,,Asian,11,8,3,0,10,7,3,0,9,7,2,0,5,5,0,0,1,1,0,0,3,2,1,0,1,1,0,0
,,American Indian/Alaska Native,5,3,2,0,5,3,2,0,3,2,1,0,2,1,1,0,1,0,1,0,0,0,0,0,1,0,1,0
,,Pacific Islander,1,1,0,0,1,1,0,0,0,0,0,0,0,0,0,0,0,0,0,0,0,0,0,0,0,0,0,0
,,Multiracial,2,2,0,0,2,2,0,0,2,2,0,0,0,0,0,0,1,1,0,0,0,0,0,0,0,0,0,0
,Missouri,All Ethnicities,5445,3202,2243,0,4797,2835,1962,0,4569,2684,1885,0,1863,1247,616,0,1127,735,392,0,1214,742,472,0,102,59,43,0
,,White,4389,2537,1852,0,3942,2290,1652,0,3657,2110,1547,0,1498,981,517,0,931,586,345,0,933,561,372,0,73,38,35,0
,,Black,874,548,326,0,703,447,256,0,760,476,284,0,301,220,81,0,159,121,38,0,233,151,82,0,23,18,5,0
,,Hispanic,114,81,33,0,95,68,27,0,93,66,27,0,42,32,10,0,25,20,5,0,29,20,9,0,3,1,2,0
,,Asian,38,17,21,0,32,15,17,0,33,15,18,0,10,6,4,0,7,3,4,0,13,6,7,0,3,2,1,0
,,American Indian/Alaska Native,15,9,6,0,11,6,5,0,13,8,5,0,5,2,3,0,3,3,0,0,3,2,1,0,0,0,0,0
,,Pacific Islander,7,5,2,0,7,5,2,0,6,4,2,0,4,4,0,0,2,2,0,0,3,2,1,0,0,0,0,0
,,Multiracial,8,5,3,0,7,4,3,0,7,5,2,0,3,2,1,0,0,0,0,0,0,0,0,0,0,0,0,0
,Montana,All Ethnicities,676,396,280,0,643,377,266,0,554,326,228,0,294,201,93,0,171,115,56,0,103,58,45,0,11,8,3,0
,,White,621,367,254,0,592,351,241,0,511,303,208,0,275,193,82,0,158,105,53,0,94,55,39,0,10,8,2,0
,,Black,4,4,0,0,3,3,0,0,4,4,0,0,1,1,0,0,2,2,0,0,1,1,0,0,0,0,0,0
,,Hispanic,16,7,9,0,15,6,9,0,13,4,9,0,5,1,4,0,3,2,1,0,4,0,4,0,0,0,0,0
,,Asian,4,2,2,0,4,2,2,0,4,2,2,0,2,1,1,0,1,1,0,0,0,0,0,0,0,0,0,0
,,American Indian/Alaska Native,29,14,15,0,27,13,14,0,20,11,9,0,11,5,6,0,6,4,2,0,4,2,2,0,1,0,1,0
,,Multiracial,2,2,0,0,2,2,0,0,2,2,0,0,0,0,0,0,1,1,0,0,0,0,0,0,0,0,0,0
,Nebraska,All Ethnicities,1283,711,572,0,1200,671,529,0,1099,607,492,0,443,282,161,0,422,254,168,0,225,126,99,0,35,16,19,0
,,White,1105,613,492,0,1036,581,455,0,946,522,424,0,375,237,138,0,381,230,151,0,190,107,83,0,29,13,16,0
,,Black,82,42,40,0,74,37,37,0,72,37,35,0,29,18,11,0,24,14,10,0,17,9,8,0,0,0,0,0
,,Hispanic,67,45,22,0,62,42,20,0,59,39,20,0,31,21,10,0,10,6,4,0,12,6,6,0,6,3,3,0
,,Asian,16,5,11,0,15,5,10,0,12,3,9,0,1,1,0,0,4,1,3,0,5,3,2,0,0,0,0,0
,,American Indian/Alaska Native,10,4,6,0,10,4,6,0,7,4,3,0,5,3,2,0,2,2,0,0,0,0,0,0,0,0,0,0
,,Multiracial,3,2,1,0,3,2,1,0,3,2,1,0,2,2,0,0,1,1,0,0,1,1,0,0,0,0,0,0
,Nevada,All Ethnicities,1992,1138,854,0,1836,1040,796,0,1648,945,703,0,706,461,245,0,310,212,98,0,336,185,151,0,21,14,7,0
,,White,1354,764,590,0,1267,713,554,0,1123,637,486,0,474,302,172,0,212,142,70,0,192,99,93,0,13,8,5,0
,,Black,177,90,87,0,152,75,77,0,151,76,75,0,56,32,24,0,25,13,12,0,34,20,14,0,1,1,0,0
,,Hispanic,323,217,106,0,298,200,98,0,256,175,81,0,140,105,35,0,53,44,9,0,69,51,18,0,7,5,2,0
,,Asian,98,44,54,0,83,32,51,0,83,37,46,0,23,13,10,0,12,6,6,0,33,9,24,0,0,0,0,0
,,American Indian/Alaska Native,8,5,3,0,8,5,3,0,4,3,1,0,4,4,0,0,1,1,0,0,0,0,0,0,0,0,0,0
,,Pacific Islander,18,9,9,0,16,8,8,0,18,9,9,0,4,2,2,0,3,3,0,0,3,2,1,0,0,0,0,0
,,Multiracial,14,9,5,0,12,7,5,0,13,8,5,0,5,3,2,0,4,3,1,0,5,4,1,0,0,0,0,0
,New Hampshire,All Ethnicities,793,460,333,0,745,435,310,0,605,356,249,0,270,173,97,0,157,99,58,0,135,67,68,0,3,3,0,0
,,White,750,435,315,0,708,415,293,0,570,336,234,0,251,161,90,0,148,96,52,0,123,62,61,0,3,3,0,0
,,Black,16,9,7,0,12,5,7,0,14,8,6,0,8,6,2,0,5,3,2,0,4,2,2,0,0,0,0,0
,,Hispanic,17,11,6,0,16,10,6,0,15,9,6,0,6,3,3,0,3,0,3,0,5,2,3,0,0,0,0,0
,,Asian,8,4,4,0,7,4,3,0,4,2,2,0,3,2,1,0,0,0,0,0,2,1,1,0,0,0,0,0
,,Multiracial,2,1,1,0,2,1,1,0,2,1,1,0,2,1,1,0,1,0,1,0,1,0,1,0,0,0,0,0
,New Jersey,All Ethnicities,5640,3249,2391,0,5231,3003,2228,0,4392,2525,1867,0,1803,1155,648,0,1096,684,412,0,780,447,333,0,43,23,20,0
,,,,,,,,,,,,,,,,,,,,,,,,,,,,,,
,,,,,,,,,,,,,,,,,,,,,,,,,,,,,,
,,White,3605,2044,1561,0,3387,1909,1478,0,2728,1557,1171,0,1083,672,411,0,669,403,266,0,442,242,200,0,20,12,8,0
,,Black,919,516,403,0,809,451,358,0,767,421,346,0,302,196,106,0,187,117,70,0,139,89,50,0,15,7,8,0
,,Hispanic,874,554,320,0,814,520,294,0,699,439,260,0,359,249,110,0,201,142,59,0,154,96,58,0,6,3,3,0
,,Unknown,2,2,0,0,2,2,0,0,2,2,0,0,2,2,0,0,2,2,0,0,1,1,0,0,0,0,0,0
,,Asian,202,117,85,0,183,105,78,0,162,93,69,0,42,29,13,0,29,17,12,0,31,14,17,0,1,1,0,0
,,American Indian/Alaska Native,1,1,0,0,1,1,0,0,1,1,0,0,0,0,0,0,0,0,0,0,1,1,0,0,0,0,0,0
,,Pacific Islander,13,6,7,0,11,6,5,0,11,4,7,0,2,1,1,0,3,0,3,0,5,1,4,0,1,0,1,0
,,Multiracial,24,9,15,0,24,9,15,0,22,8,14,0,13,6,7,0,5,3,2,0,7,3,4,0,0,0,0,0
,New Mexico,All Ethnicities,1459,862,597,0,1363,805,558,0,1152,674,478,0,543,380,163,0,201,129,72,0,194,121,73,0,18,13,5,0
,,White,735,419,316,0,683,382,301,0,584,326,258,0,252,173,79,0,101,60,41,0,96,64,32,0,7,5,2,0
,,Black,40,22,18,0,37,21,16,0,37,20,17,0,14,10,4,0,6,4,2,0,5,2,3,0,0,0,0,0
,,Hispanic,632,391,241,0,594,374,220,0,492,306,186,0,257,181,76,0,89,61,28,0,87,51,36,0,10,8,2,0
,,Asian,12,5,7,0,11,4,7,0,12,5,7,0,3,2,1,0,0,0,0,0,1,0,1,0,0,0,0,0
,,American Indian/Alaska Native,35,24,11,0,33,23,10,0,23,16,7,0,15,13,2,0,5,4,1,0,5,4,1,0,0,0,0,0
,,Multiracial,5,1,4,0,5,1,4,0,4,1,3,0,2,1,1,0,0,0,0,0,0,0,0,0,1,0,1,0
,New York,All Ethnicities,11042,6390,4652,0,9458,5518,3940,0,8959,5134,3825,0,3344,2240,1104,0,1761,1120,641,0,1111,634,477,0,140,84,56,0
,,White,6670,3750,2920,0,5879,3316,2563,0,5308,2944,2364,0,1912,1222,690,0,1074,658,416,0,649,337,312,0,75,46,29,0
,,Black,1869,1062,807,0,1466,857,609,0,1601,914,687,0,589,403,186,0,300,210,90,0,200,129,71,0,31,16,15,0
,,Hispanic,2032,1321,711,0,1707,1125,582,0,1668,1071,597,0,714,529,185,0,309,206,103,0,216,147,69,0,25,16,9,0
,,Unknown,4,2,2,0,4,2,2,0,2,1,1,0,1,0,1,0,1,1,0,0,0,0,0,0,0,0,0,0
,,Asian,292,142,150,0,255,126,129,0,239,114,125,0,60,35,25,0,47,22,25,0,29,10,19,0,4,2,2,0
,,American Indian/Alaska Native,16,11,5,0,15,11,4,0,7,6,1,0,8,6,2,0,2,2,0,0,2,2,0,0,0,0,0,0
,,Pacific Islander,10,7,3,0,9,6,3,0,9,6,3,0,0,0,0,0,1,1,0,0,2,2,0,0,0,0,0,0
,,Multiracial,149,95,54,0,123,75,48,0,125,78,47,0,60,45,15,0,27,20,7,0,13,7,6,0,5,4,1,0
,North Carolina,All Ethnicities,6264,3735,2529,0,5749,3411,2338,0,4985,2953,2032,0,2437,1661,776,0,1520,1006,514,0,1319,805,514,0,127,73,54,0
,,White,4516,2642,1874,0,4200,2448,1752,0,3526,2043,1483,0,1726,1159,567,0,1092,694,398,0,857,504,353,0,66,40,26,0
,,Black,1376,829,547,0,1198,712,486,0,1148,690,458,0,536,361,175,0,328,240,88,0,353,222,131,0,45,22,23,0
,,Hispanic,255,190,65,0,239,180,59,0,211,156,55,0,132,110,22,0,72,51,21,0,77,57,20,0,13,8,5,0
,,Unknown,2,1,1,0,2,1,1,0,2,1,1,0,1,0,1,0,1,0,1,0,0,0,0,0,0,0,0,0
,,Asian,51,31,20,0,50,30,20,0,41,27,14,0,16,10,6,0,11,7,4,0,13,7,6,0,1,1,0,0
,,American Indian/Alaska Native,51,32,19,0,48,31,17,0,45,27,18,0,20,15,5,0,15,13,2,0,13,9,4,0,2,2,0,0
,,Pacific Islander,1,1,0,0,1,1,0,0,1,1,0,0,1,1,0,0,0,0,0,0,1,1,0,0,0,0,0,0
,,Multiracial,12,9,3,0,11,8,3,0,11,8,3,0,5,5,0,0,1,1,0,0,5,5,0,0,0,0,0,0
,North Dakota,All Ethnicities,464,274,190,0,440,263,177,0,380,220,160,0,171,119,52,0,181,115,66,0,76,39,37,0,13,7,6,0
,,White,431,252,179,0,407,241,166,0,353,203,150,0,155,107,48,0,168,107,61,0,66,34,32,0,11,5,6,0
,,Black,7,5,2,0,7,5,2,0,7,5,2,0,3,1,2,0,1,1,0,0,3,1,2,0,1,1,0,0
,,Hispanic,7,5,2,0,7,5,2,0,5,3,2,0,3,2,1,0,2,0,2,0,2,1,1,0,0,0,0,0
,,Asian,2,0,2,0,2,0,2,0,1,0,1,0,0,0,0,0,0,0,0,0,0,0,0,0,0,0,0,0
,,American Indian/Alaska Native,16,11,5,0,16,11,5,0,13,8,5,0,9,8,1,0,9,6,3,0,5,3,2,0,1,1,0,0
,,Multiracial,1,1,0,0,1,1,0,0,1,1,0,0,1,1,0,0,1,1,0,0,0,0,0,0,0,0,0,0
,Ohio,All Ethnicities,8889,5239,3650,0,8211,4825,3386,0,7199,4272,2927,0,2999,1992,1007,0,2374,1543,831,0,1666,953,713,0,137,83,54,0
,,,,,,,,,,,,,,,,,,,,,,,,,,,,,,
,,,,,,,,,,,,,,,,,,,,,,,,,,,,,,
,,White,7455,4327,3128,0,6956,4025,2931,0,5963,3485,2478,0,2468,1604,864,0,1959,1245,714,0,1315,721,594,0,110,66,44,0
,,Black,1230,781,449,0,1068,681,387,0,1069,678,391,0,445,326,119,0,351,251,100,0,305,201,104,0,20,12,8,0
,,Hispanic,123,77,46,0,115,72,43,0,104,64,40,0,62,42,20,0,40,28,12,0,29,18,11,0,4,3,1,0
,,Unknown,2,2,0,0,2,2,0,0,1,1,0,0,1,1,0,0,0,0,0,0,0,0,0,0,0,0,0,0
,,Asian,61,38,23,0,55,34,21,0,48,32,16,0,17,14,3,0,18,13,5,0,12,9,3,0,2,1,1,0
,,American Indian/Alaska Native,2,2,0,0,1,1,0,0,2,2,0,0,0,0,0,0,0,0,0,0,0,0,0,0,0,0,0,0
,,Pacific Islander,1,0,1,0,1,0,1,0,0,0,0,0,0,0,0,0,0,0,0,0,0,0,0,0,0,0,0,0
,,Multiracial,15,12,3,0,13,10,3,0,12,10,2,0,6,5,1,0,6,6,0,0,5,4,1,0,1,1,0,0
,Oklahoma,All Ethnicities,3061,1824,1237,0,2836,1685,1151,0,2400,1414,986,0,1094,729,365,0,392,276,116,0,451,291,160,0,31,15,16,0
,,White,2523,1506,1017,0,2346,1399,947,0,1967,1157,810,0,899,600,299,0,312,217,95,0,352,229,123,0,25,12,13,0
,,Black,254,154,100,0,229,135,94,0,206,130,76,0,91,67,24,0,34,25,9,0,50,32,18,0,4,2,2,0
,,Hispanic,135,86,49,0,125,79,46,0,107,66,41,0,51,36,15,0,28,21,7,0,30,21,9,0,1,0,1,0
,,Asian,27,11,16,0,26,10,16,0,20,9,11,0,8,3,5,0,1,0,1,0,1,0,1,0,1,1,0,0
,,American Indian/Alaska Native,113,61,52,0,102,57,45,0,92,47,45,0,39,19,20,0,14,11,3,0,17,9,8,0,0,0,0,0
,,Pacific Islander,3,1,2,0,3,1,2,0,3,1,2,0,2,1,1,0,1,1,0,0,1,0,1,0,0,0,0,0
,,Multiracial,6,5,1,0,5,4,1,0,5,4,1,0,4,3,1,0,2,1,1,0,0,0,0,0,0,0,0,0
,Oregon,All Ethnicities,2031,1196,835,0,1953,1150,803,0,1667,975,692,0,761,501,260,0,414,282,132,0,264,153,111,0,10,7,3,0
,,White,1816,1056,760,0,1750,1014,736,0,1493,860,633,0,660,432,228,0,369,252,117,0,222,121,101,0,9,6,3,0
,,Black,36,25,11,0,33,24,9,0,30,22,8,0,18,13,5,0,6,5,1,0,4,4,0,0,0,0,0,0
,,Hispanic,117,82,35,0,113,81,32,0,92,65,27,0,62,44,18,0,30,22,8,0,23,18,5,0,1,1,0,0
,,Asian,39,18,21,0,38,18,20,0,32,15,17,0,13,5,8,0,7,2,5,0,9,4,5,0,0,0,0,0
,,American Indian/Alaska Native,6,3,3,0,5,3,2,0,4,1,3,0,1,1,0,0,0,0,0,0,0,0,0,0,0,0,0,0
,,Pacific Islander,10,6,4,0,8,5,3,0,9,6,3,0,4,3,1,0,1,1,0,0,4,4,0,0,0,0,0,0
,,Multiracial,7,6,1,0,6,5,1,0,7,6,1,0,3,3,0,0,1,0,1,0,2,2,0,0,0,0,0,0
,Pennsylvania,All Ethnicities,12791,7678,5113,0,11770,7031,4739,0,10447,6257,4190,0,4008,2724,1284,0,2689,1727,962,0,2259,1373,886,0,177,105,72,0
,,White,10323,6088,4235,0,9601,5626,3975,0,8384,4939,3445,0,3172,2128,1044,0,2180,1346,834,0,1733,1007,726,0,144,84,60,0
,,Black,1687,1079,608,0,1468,948,520,0,1419,900,519,0,546,391,155,0,356,272,84,0,346,250,96,0,22,16,6,0
,,Hispanic,617,410,207,0,549,364,185,0,511,340,171,0,235,168,67,0,129,94,35,0,137,94,43,0,10,5,5,0
,,Unknown,1,1,0,0,1,1,0,0,1,1,0,0,0,0,0,0,0,0,0,0,0,0,0,0,0,0,0,0
,,Asian,121,72,49,0,110,65,45,0,98,55,43,0,35,21,14,0,18,11,7,0,31,14,17,0,1,0,1,0
,,American Indian/Alaska Native,7,5,2,0,6,4,2,0,5,3,2,0,5,4,1,0,1,0,1,0,2,2,0,0,0,0,0,0
,,Pacific Islander,2,1,1,0,2,1,1,0,2,1,1,0,0,0,0,0,0,0,0,0,0,0,0,0,0,0,0,0
,,Multiracial,33,22,11,0,33,22,11,0,27,18,9,0,15,12,3,0,5,4,1,0,10,6,4,0,0,0,0,0
,Puerto Rico,All Ethnicities,1879,1147,732,0,1635,996,639,0,1526,939,587,0,355,287,68,0,244,184,60,0,245,173,72,0,29,20,9,0
,,White,18,15,3,0,14,12,2,0,11,9,2,0,3,2,1,0,0,0,0,0,0,0,0,0,1,1,0,0
,,Black,2,1,1,0,2,1,1,0,1,1,0,0,1,1,0,0,1,1,0,0,1,1,0,0,0,0,0,0
,,Hispanic,1195,729,466,0,1054,642,412,0,931,568,363,0,237,187,50,0,136,100,36,0,106,73,33,0,21,15,6,0
,,Multiracial,664,402,262,0,565,341,224,0,583,361,222,0,114,97,17,0,107,83,24,0,138,99,39,0,7,4,3,0
,Rhode Island,All Ethnicities,502,296,206,0,468,275,193,0,356,210,146,0,178,112,66,0,102,63,39,0,58,27,31,0,4,3,1,0
,,White,419,243,176,0,392,226,166,0,296,172,124,0,148,90,58,0,86,53,33,0,52,23,29,0,2,1,1,0
,,Black,26,19,7,0,25,19,6,0,15,12,3,0,7,6,1,0,1,1,0,0,1,1,0,0,0,0,0,0
,,,,,,,,,,,,,,,,,,,,,,,,,,,,,,
,,,,,,,,,,,,,,,,,,,,,,,,,,,,,,
,,Hispanic,46,27,19,0,41,24,17,0,38,21,17,0,19,14,5,0,12,7,5,0,4,2,2,0,2,2,0,0
,,Asian,7,4,3,0,7,4,3,0,4,2,2,0,2,0,2,0,2,1,1,0,1,1,0,0,0,0,0,0
,,Pacific Islander,2,2,0,0,1,1,0,0,2,2,0,0,1,1,0,0,1,1,0,0,0,0,0,0,0,0,0,0
,,Multiracial,2,1,1,0,2,1,1,0,1,1,0,0,1,1,0,0,0,0,0,0,0,0,0,0,0,0,0,0
,South Carolina,All Ethnicities,3659,2200,1459,0,3404,2052,1352,0,3172,1902,1270,0,1413,1016,397,0,760,542,218,0,732,479,253,0,51,33,18,0
,,White,2571,1533,1038,0,2438,1453,985,0,2203,1305,898,0,1023,724,299,0,555,386,169,0,459,296,163,0,31,19,12,0
,,Black,949,559,390,0,835,497,338,0,846,501,345,0,325,236,89,0,174,132,42,0,239,156,83,0,19,14,5,0
,,Hispanic,104,84,20,0,99,80,19,0,92,74,18,0,53,47,6,0,24,20,4,0,26,21,5,0,0,0,0,0
,,Unknown,1,0,1,0,1,0,1,0,0,0,0,0,0,0,0,0,1,0,1,0,0,0,0,0,0,0,0,0
,,Asian,23,18,5,0,21,17,4,0,20,16,4,0,6,6,0,0,4,3,1,0,5,4,1,0,0,0,0,0
,,American Indian/Alaska Native,2,0,2,0,2,0,2,0,2,0,2,0,2,0,2,0,1,0,1,0,1,0,1,0,1,0,1,0
,,Pacific Islander,1,1,0,0,1,1,0,0,1,1,0,0,1,1,0,0,1,1,0,0,0,0,0,0,0,0,0,0
,,Multiracial,8,5,3,0,7,4,3,0,8,5,3,0,3,2,1,0,0,0,0,0,2,2,0,0,0,0,0,0
,South Dakota,All Ethnicities,557,328,229,0,530,311,219,0,487,287,200,0,202,130,72,0,232,138,94,0,124,70,54,0,16,10,6,0
,,White,484,279,205,0,464,267,197,0,422,241,181,0,172,111,61,0,202,117,85,0,104,57,47,0,15,9,6,0
,,Black,12,8,4,0,9,6,3,0,11,7,4,0,7,4,3,0,3,0,3,0,7,4,3,0,1,1,0,0
,,Hispanic,7,6,1,0,6,5,1,0,7,6,1,0,2,2,0,0,5,5,0,0,4,3,1,0,0,0,0,0
,,Asian,3,2,1,0,3,2,1,0,2,2,0,0,0,0,0,0,0,0,0,0,0,0,0,0,0,0,0,0
,,American Indian/Alaska Native,47,30,17,0,44,28,16,0,41,28,13,0,21,13,8,0,20,15,5,0,9,6,3,0,0,0,0,0
,,Pacific Islander,2,1,1,0,2,1,1,0,2,1,1,0,0,0,0,0,2,1,1,0,0,0,0,0,0,0,0,0
,,Multiracial,2,2,0,0,2,2,0,0,2,2,0,0,0,0,0,0,0,0,0,0,0,0,0,0,0,0,0,0
,State unassigned,All Ethnicities,3170,1989,1181,0,2945,1853,1092,0,2310,1482,828,0,1273,933,340,0,636,456,180,0,449,296,153,0,25,10,15,0
,,White,1600,931,669,0,1508,877,631,0,1105,659,446,0,619,419,200,0,283,183,100,0,183,100,83,0,5,3,2,0
,,Black,343,221,122,0,306,199,107,0,269,180,89,0,132,106,26,0,65,53,12,0,56,45,11,0,6,1,5,0
,,Hispanic,925,676,249,0,849,626,223,0,700,518,182,0,428,352,76,0,229,185,44,0,168,129,39,0,9,4,5,0
,,Unknown,121,67,54,0,115,63,52,0,97,54,43,0,48,30,18,0,33,18,15,0,14,7,7,0,3,2,1,0
,,Asian,148,75,73,0,139,69,70,0,114,57,57,0,36,16,20,0,21,13,8,0,25,14,11,0,2,0,2,0
,,American Indian/Alaska Native,5,4,1,0,5,4,1,0,3,2,1,0,2,2,0,0,1,1,0,0,1,1,0,0,0,0,0,0
,,Pacific Islander,9,2,7,0,4,2,2,0,8,2,6,0,1,1,0,0,0,0,0,0,2,0,2,0,0,0,0,0
,,Multiracial,19,13,6,0,19,13,6,0,14,10,4,0,7,7,0,0,4,3,1,0,0,0,0,0,0,0,0,0
,Tennessee,All Ethnicities,5244,3069,2175,0,4765,2784,1981,0,4417,2567,1850,0,2090,1427,663,0,1155,766,389,0,970,586,384,0,129,70,59,0
,,White,4232,2427,1805,0,3885,2218,1667,0,3533,2006,1527,0,1674,1119,555,0,900,575,325,0,735,425,310,0,91,46,45,0
,,Black,814,521,293,0,701,454,247,0,705,453,252,0,306,230,76,0,195,148,47,0,180,123,57,0,27,16,11,0
,,Hispanic,148,100,48,0,133,92,41,0,136,91,45,0,89,66,23,0,47,36,11,0,44,33,11,0,7,6,1,0
,,Unknown,1,0,1,0,1,0,1,0,1,0,1,0,1,0,1,0,0,0,0,0,0,0,0,0,0,0,0,0
,,Asian,31,10,21,0,29,9,20,0,27,8,19,0,12,7,5,0,8,4,4,0,6,3,3,0,3,2,1,0
,,American Indian/Alaska Native,7,5,2,0,6,5,1,0,5,3,2,0,3,2,1,0,2,1,1,0,0,0,0,0,0,0,0,0
,,Pacific Islander,4,2,2,0,4,2,2,0,4,2,2,0,2,1,1,0,1,0,1,0,3,1,2,0,1,0,1,0
,,Multiracial,7,4,3,0,6,4,2,0,6,4,2,0,3,2,1,0,2,2,0,0,2,1,1,0,0,0,0,0
,Texas,All Ethnicities,17342,10402,6940,0,15560,9368,6192,0,13995,8413,5582,0,6829,4760,2069,0,2615,1826,789,0,3458,2122,1336,0,207,130,77,0
,,White,9888,5728,4160,0,8985,5221,3764,0,7886,4572,3314,0,3799,2585,1214,0,1502,1001,501,0,1764,1050,714,0,94,61,33,0
,,,,,,,,,,,,,,,,,,,,,,,,,,,,,,
,,,,,,,,,,,,,,,,,,,,,,,,,,,,,,
,,Black,2355,1392,963,0,1960,1170,790,0,1984,1181,803,0,870,605,265,0,359,267,92,0,528,321,207,0,36,19,17,0
,,Hispanic,4706,3080,1626,0,4271,2803,1468,0,3796,2492,1304,0,2033,1486,547,0,700,523,177,0,1081,709,372,0,71,48,23,0
,,Unknown,27,16,11,0,25,15,10,0,16,11,5,0,11,7,4,0,2,1,1,0,1,1,0,0,0,0,0,0
,,Asian,297,150,147,0,260,129,131,0,255,129,126,0,86,58,28,0,41,28,13,0,71,35,36,0,5,2,3,0
,,American Indian/Alaska Native,14,12,2,0,12,10,2,0,11,9,2,0,6,5,1,0,2,2,0,0,4,2,2,0,0,0,0,0
,,Pacific Islander,10,4,6,0,9,4,5,0,9,4,5,0,4,2,2,0,1,1,0,0,3,2,1,0,0,0,0,0
,,Multiracial,45,20,25,0,38,16,22,0,38,15,23,0,20,12,8,0,8,3,5,0,6,2,4,0,1,0,1,0
,Utah,All Ethnicities,1727,1029,698,0,1613,967,646,0,1363,833,530,0,702,458,244,0,375,249,126,0,254,153,101,0,13,8,5,0
,,White,1528,902,626,0,1428,850,578,0,1214,737,477,0,620,397,223,0,341,222,119,0,223,133,90,0,12,7,5,0
,,Black,19,10,9,0,16,7,9,0,15,7,8,0,7,6,1,0,3,2,1,0,3,1,2,0,0,0,0,0
,,Hispanic,133,92,41,0,125,86,39,0,99,71,28,0,58,45,13,0,26,21,5,0,22,16,6,0,1,1,0,0
,,Asian,24,15,9,0,22,14,8,0,20,12,8,0,7,5,2,0,5,4,1,0,4,2,2,0,0,0,0,0
,,American Indian/Alaska Native,8,5,3,0,7,5,2,0,5,3,2,0,5,3,2,0,0,0,0,0,0,0,0,0,0,0,0,0
,,Pacific Islander,9,3,6,0,9,3,6,0,6,1,5,0,4,1,3,0,0,0,0,0,2,1,1,0,0,0,0,0
,,Multiracial,6,2,4,0,6,2,4,0,4,2,2,0,1,1,0,0,0,0,0,0,0,0,0,0,0,0,0,0
,Vermont,All Ethnicities,398,230,168,0,381,218,163,0,316,185,131,0,138,89,49,0,85,55,30,0,61,35,26,0,3,1,2,0
,,White,388,227,161,0,373,217,156,0,310,182,128,0,135,87,48,0,84,55,29,0,59,34,25,0,3,1,2,0
,,Black,8,2,6,0,6,0,6,0,5,2,3,0,2,1,1,0,1,0,1,0,1,0,1,0,0,0,0,0
,,Hispanic,1,1,0,0,1,1,0,0,1,1,0,0,1,1,0,0,0,0,0,0,1,1,0,0,0,0,0,0
,,Unknown,1,0,1,0,1,0,1,0,0,0,0,0,0,0,0,0,0,0,0,0,0,0,0,0,0,0,0,0
,Virginia,All Ethnicities,4974,2950,2024,0,4664,2766,1898,0,4058,2416,1642,0,1761,1192,569,0,915,610,305,0,912,551,361,0,75,38,37,0
,,White,3529,2098,1431,0,3333,1984,1349,0,2875,1709,1166,0,1262,855,407,0,656,432,224,0,603,353,250,0,43,19,24,0
,,Black,1076,630,446,0,985,578,407,0,883,521,362,0,370,250,120,0,163,117,46,0,218,138,80,0,26,15,11,0
,,Hispanic,191,131,60,0,179,121,58,0,156,108,48,0,74,55,19,0,56,37,19,0,47,35,12,0,4,3,1,0
,,Asian,154,77,77,0,144,69,75,0,125,66,59,0,43,25,18,0,33,19,14,0,38,20,18,0,2,1,1,0
,,American Indian/Alaska Native,6,4,2,0,6,4,2,0,5,3,2,0,2,1,1,0,2,1,1,0,2,2,0,0,0,0,0,0
,,Pacific Islander,5,3,2,0,5,3,2,0,3,2,1,0,3,2,1,0,1,1,0,0,2,1,1,0,0,0,0,0
,,Multiracial,13,7,6,0,12,7,5,0,11,7,4,0,7,4,3,0,4,3,1,0,2,2,0,0,0,0,0,0
,Washington,All Ethnicities,3480,2078,1402,0,3325,1992,1333,0,2738,1641,1097,0,1214,805,409,0,723,474,249,0,595,340,255,0,26,13,13,0
,,White,2887,1694,1193,0,2764,1627,1137,0,2251,1322,929,0,985,642,343,0,604,390,214,0,478,271,207,0,18,8,10,0
,,Black,140,94,46,0,130,89,41,0,122,83,39,0,57,41,16,0,34,25,9,0,31,22,9,0,3,2,1,0
,,Hispanic,222,149,73,0,212,143,69,0,181,122,59,0,95,71,24,0,43,30,13,0,42,23,19,0,2,1,1,0
,,Unknown,4,3,1,0,3,2,1,0,4,3,1,0,2,2,0,0,1,1,0,0,0,0,0,0,0,0,0,0
,,Asian,133,73,60,0,125,69,56,0,104,58,46,0,36,21,15,0,23,14,9,0,27,14,13,0,1,0,1,0
,,American Indian/Alaska Native,42,24,18,0,41,23,18,0,33,19,14,0,17,10,7,0,8,5,3,0,11,6,5,0,0,0,0,0
,,Pacific Islander,20,16,4,0,20,16,4,0,17,14,3,0,5,5,0,0,4,4,0,0,0,0,0,0,1,1,0,0
,,Multiracial,32,25,7,0,30,23,7,0,26,20,6,0,17,13,4,0,6,5,1,0,6,4,2,0,1,1,0,0
,West Virginia,All Ethnicities,1603,909,694,0,1483,840,643,0,1367,766,601,0,495,329,166,0,375,242,133,0,269,157,112,0,42,27,15,0
,,White,1500,847,653,0,1393,788,605,0,1275,713,562,0,451,303,148,0,348,225,123,0,243,143,100,0,40,26,14,0
,,Black,86,52,34,0,74,42,32,0,76,44,32,0,35,20,15,0,19,11,8,0,20,10,10,0,2,1,1,0
,,Hispanic,15,9,6,0,14,9,5,0,14,8,6,0,7,5,2,0,7,5,2,0,4,3,1,0,0,0,0,0
,,,,,,,,,,,,,,,,,,,,,,,,,,,,,,
,,,,,,,,,,,,,,,,,,,,,,,,,,,,,,
,,Asian,2,1,1,0,2,1,1,0,2,1,1,0,2,1,1,0,1,1,0,0,2,1,1,0,0,0,0,0
,Wisconsin,All Ethnicities,5163,3157,2006,0,4813,2959,1854,0,4138,2512,1626,0,1715,1179,536,0,1890,1191,699,0,857,499,358,0,42,26,16,0
,,White,4517,2741,1776,0,4252,2588,1664,0,3598,2170,1428,0,1454,976,478,0,1701,1056,645,0,729,409,320,0,33,19,14,0
,,Black,398,252,146,0,333,220,113,0,346,215,131,0,164,131,33,0,108,79,29,0,84,61,23,0,5,4,1,0
,,Hispanic,179,129,50,0,163,119,44,0,141,102,39,0,72,60,12,0,59,48,11,0,32,24,8,0,3,2,1,0
,,Asian,41,16,25,0,38,13,25,0,32,12,20,0,11,3,8,0,11,1,10,0,9,3,6,0,0,0,0,0
,,American Indian/Alaska Native,15,11,4,0,14,11,3,0,12,8,4,0,6,5,1,0,8,6,2,0,2,2,0,0,0,0,0,0
,,Pacific Islander,2,0,2,0,2,0,2,0,2,0,2,0,2,0,2,0,2,0,2,0,1,0,1,0,0,0,0,0
,,Multiracial,11,8,3,0,11,8,3,0,7,5,2,0,6,4,2,0,1,1,0,0,0,0,0,0,1,1,0,0
,Wyoming,All Ethnicities,419,268,151,0,396,251,145,0,346,224,122,0,184,140,44,0,112,82,30,0,73,46,27,0,1,1,0,0
,,White,394,254,140,0,372,238,134,0,323,211,112,0,171,131,40,0,107,80,27,0,70,44,26,0,1,1,0,0
,,Black,5,4,1,0,5,4,1,0,5,4,1,0,4,4,0,0,0,0,0,0,1,1,0,0,0,0,0,0
,,Hispanic,13,7,6,0,12,6,6,0,12,7,5,0,6,3,3,0,4,2,2,0,1,0,1,0,0,0,0,0
,,Asian,2,1,1,0,2,1,1,0,1,0,1,0,0,0,0,0,0,0,0,0,1,1,0,0,0,0,0,0
,,American Indian/Alaska Native,5,2,3,0,5,2,3,0,5,2,3,0,3,2,1,0,1,0,1,0,0,0,0,0,0,0,0,0
Living Donor,All Donor States of Residence,All Ethnicities,165076,66889,98186,1,157281,63077,94203,1,7210,3462,3748,0,43,20,23,0,72,26,46,0,478,301,177,0,44,23,21,0
,,White,116891,46892,69999,0,110789,43901,66888,0,5590,2691,2899,0,42,19,23,0,60,22,38,0,423,264,159,0,26,11,15,0
,,Black,19094,8085,11009,0,18693,7870,10823,0,385,203,182,0,0,0,0,0,5,2,3,0,6,4,2,0,9,7,2,0
,,Hispanic,21197,8762,12435,0,20238,8314,11924,0,912,415,497,0,1,1,0,0,4,1,3,0,39,28,11,0,9,5,4,0
,,Unknown,111,44,66,1,108,44,63,1,2,0,2,0,0,0,0,0,1,1,0,0,1,0,1,0,0,0,0,0
,,Asian,5135,2084,3051,0,4906,1975,2931,0,222,106,116,0,0,0,0,0,2,0,2,0,7,3,4,0,0,0,0,0
,,American Indian/Alaska Native,864,293,571,0,844,284,560,0,20,9,11,0,0,0,0,0,0,0,0,0,0,0,0,0,0,0,0,0
,,Pacific Islander,718,317,401,0,700,311,389,0,16,4,12,0,0,0,0,0,0,0,0,0,2,2,0,0,0,0,0,0
,,Multiracial,1066,412,654,0,1003,378,625,0,63,34,29,0,0,0,0,0,0,0,0,0,0,0,0,0,0,0,0,0
,Alabama,All Ethnicities,2588,1033,1555,0,2562,1017,1545,0,20,13,7,0,2,1,1,0,1,0,1,0,3,2,1,0,0,0,0,0
,,White,1914,751,1163,0,1889,736,1153,0,19,12,7,0,2,1,1,0,1,0,1,0,3,2,1,0,0,0,0,0
,,Black,620,262,358,0,619,261,358,0,1,1,0,0,0,0,0,0,0,0,0,0,0,0,0,0,0,0,0,0
,,Hispanic,30,11,19,0,30,11,19,0,0,0,0,0,0,0,0,0,0,0,0,0,0,0,0,0,0,0,0,0
,,Asian,18,6,12,0,18,6,12,0,0,0,0,0,0,0,0,0,0,0,0,0,0,0,0,0,0,0,0,0
,,American Indian/Alaska Native,3,2,1,0,3,2,1,0,0,0,0,0,0,0,0,0,0,0,0,0,0,0,0,0,0,0,0,0
,,Multiracial,3,1,2,0,3,1,2,0,0,0,0,0,0,0,0,0,0,0,0,0,0,0,0,0,0,0,0,0
,Alaska,All Ethnicities,386,161,225,0,375,156,219,0,9,4,5,0,1,0,1,0,0,0,0,0,1,1,0,0,0,0,0,0
,,White,317,132,185,0,308,129,179,0,7,2,5,0,1,0,1,0,0,0,0,0,1,1,0,0,0,0,0,0
,,Black,17,6,11,0,16,5,11,0,1,1,0,0,0,0,0,0,0,0,0,0,0,0,0,0,0,0,0,0
,,Hispanic,7,3,4,0,7,3,4,0,0,0,0,0,0,0,0,0,0,0,0,0,0,0,0,0,0,0,0,0
,,Asian,5,3,2,0,4,2,2,0,1,1,0,0,0,0,0,0,0,0,0,0,0,0,0,0,0,0,0,0
,,American Indian/Alaska Native,31,14,17,0,31,14,17,0,0,0,0,0,0,0,0,0,0,0,0,0,0,0,0,0,0,0,0,0
,,Pacific Islander,5,1,4,0,5,1,4,0,0,0,0,0,0,0,0,0,0,0,0,0,0,0,0,0,0,0,0,0
,,Multiracial,4,2,2,0,4,2,2,0,0,0,0,0,0,0,0,0,0,0,0,0,0,0,0,0,0,0,0,0
,Arizona,All Ethnicities,3236,1277,1959,0,3073,1193,1880,0,136,65,71,0,2,1,1,0,0,0,0,0,25,18,7,0,0,0,0,0
,,White,2204,860,1344,0,2072,793,1279,0,107,50,57,0,2,1,1,0,0,0,0,0,23,16,7,0,0,0,0,0
,,,,,,,,,,,,,,,,,,,,,,,,,,,,,,
,,,,,,,,,,,,,,,,,,,,,,,,,,,,,,
,,Black,135,64,71,0,132,63,69,0,3,1,2,0,0,0,0,0,0,0,0,0,0,0,0,0,0,0,0,0
,,Hispanic,684,283,401,0,658,268,390,0,24,13,11,0,0,0,0,0,0,0,0,0,2,2,0,0,0,0,0,0
,,Asian,59,20,39,0,58,19,39,0,1,1,0,0,0,0,0,0,0,0,0,0,0,0,0,0,0,0,0,0
,,American Indian/Alaska Native,120,34,86,0,119,34,85,0,1,0,1,0,0,0,0,0,0,0,0,0,0,0,0,0,0,0,0,0
,,Pacific Islander,9,6,3,0,9,6,3,0,0,0,0,0,0,0,0,0,0,0,0,0,0,0,0,0,0,0,0,0
,,Multiracial,25,10,15,0,25,10,15,0,0,0,0,0,0,0,0,0,0,0,0,0,0,0,0,0,0,0,0,0
,Arkansas,All Ethnicities,1065,417,648,0,1033,402,631,0,25,12,13,0,0,0,0,0,1,0,1,0,6,3,3,0,0,0,0,0
,,White,867,337,530,0,837,323,514,0,23,11,12,0,0,0,0,0,1,0,1,0,6,3,3,0,0,0,0,0
,,Black,161,63,98,0,160,63,97,0,1,0,1,0,0,0,0,0,0,0,0,0,0,0,0,0,0,0,0,0
,,Hispanic,20,10,10,0,20,10,10,0,0,0,0,0,0,0,0,0,0,0,0,0,0,0,0,0,0,0,0,0
,,Asian,10,4,6,0,9,3,6,0,1,1,0,0,0,0,0,0,0,0,0,0,0,0,0,0,0,0,0,0
,,American Indian/Alaska Native,2,2,0,0,2,2,0,0,0,0,0,0,0,0,0,0,0,0,0,0,0,0,0,0,0,0,0,0
,,Pacific Islander,2,0,2,0,2,0,2,0,0,0,0,0,0,0,0,0,0,0,0,0,0,0,0,0,0,0,0,0
,,Multiracial,3,1,2,0,3,1,2,0,0,0,0,0,0,0,0,0,0,0,0,0,0,0,0,0,0,0,0,0
,California,All Ethnicities,17042,6934,10108,0,16025,6428,9597,0,876,417,459,0,9,4,5,0,1,0,1,0,129,84,45,0,2,1,1,0
,,White,8880,3646,5234,0,8287,3320,4967,0,480,256,224,0,8,3,5,0,0,0,0,0,104,67,37,0,1,0,1,0
,,Black,1154,483,671,0,1119,461,658,0,31,19,12,0,0,0,0,0,1,0,1,0,2,2,0,0,1,1,0,0
,,Hispanic,5070,2039,3031,0,4776,1912,2864,0,273,112,161,0,1,1,0,0,0,0,0,0,20,14,6,0,0,0,0,0
,,Unknown,2,1,1,0,2,1,1,0,0,0,0,0,0,0,0,0,0,0,0,0,0,0,0,0,0,0,0,0
,,Asian,1440,561,879,0,1359,537,822,0,79,24,55,0,0,0,0,0,0,0,0,0,2,0,2,0,0,0,0,0
,,American Indian/Alaska Native,51,16,35,0,51,16,35,0,0,0,0,0,0,0,0,0,0,0,0,0,0,0,0,0,0,0,0,0
,,Pacific Islander,256,117,139,0,251,114,137,0,4,2,2,0,0,0,0,0,0,0,0,0,1,1,0,0,0,0,0,0
,,Multiracial,189,71,118,0,180,67,113,0,9,4,5,0,0,0,0,0,0,0,0,0,0,0,0,0,0,0,0,0
,Colorado,All Ethnicities,2799,1211,1588,0,2601,1114,1487,0,192,92,100,0,0,0,0,0,0,0,0,0,5,4,1,0,1,1,0,0
,,White,2196,933,1263,0,2034,853,1181,0,157,76,81,0,0,0,0,0,0,0,0,0,4,3,1,0,1,1,0,0
,,Black,97,53,44,0,93,50,43,0,4,3,1,0,0,0,0,0,0,0,0,0,0,0,0,0,0,0,0,0
,,Hispanic,428,194,234,0,400,181,219,0,27,12,15,0,0,0,0,0,0,0,0,0,1,1,0,0,0,0,0,0
,,Unknown,1,0,1,0,1,0,1,0,0,0,0,0,0,0,0,0,0,0,0,0,0,0,0,0,0,0,0,0
,,Asian,43,18,25,0,42,18,24,0,1,0,1,0,0,0,0,0,0,0,0,0,0,0,0,0,0,0,0,0
,,American Indian/Alaska Native,9,3,6,0,9,3,6,0,0,0,0,0,0,0,0,0,0,0,0,0,0,0,0,0,0,0,0,0
,,Pacific Islander,6,4,2,0,6,4,2,0,0,0,0,0,0,0,0,0,0,0,0,0,0,0,0,0,0,0,0,0
,,Multiracial,19,6,13,0,16,5,11,0,3,1,2,0,0,0,0,0,0,0,0,0,0,0,0,0,0,0,0,0
,Connecticut,All Ethnicities,2095,839,1256,0,1975,783,1192,0,118,54,64,0,0,0,0,0,1,1,0,0,2,2,0,0,0,0,0,0
,,White,1638,655,983,0,1533,610,923,0,103,43,60,0,0,0,0,0,1,1,0,0,2,2,0,0,0,0,0,0
,,Black,184,79,105,0,179,75,104,0,5,4,1,0,0,0,0,0,0,0,0,0,0,0,0,0,0,0,0,0
,,Hispanic,210,84,126,0,202,79,123,0,8,5,3,0,0,0,0,0,0,0,0,0,0,0,0,0,0,0,0,0
,,Asian,42,14,28,0,40,12,28,0,2,2,0,0,0,0,0,0,0,0,0,0,0,0,0,0,0,0,0,0
,,American Indian/Alaska Native,2,0,2,0,2,0,2,0,0,0,0,0,0,0,0,0,0,0,0,0,0,0,0,0,0,0,0,0
,,Pacific Islander,5,3,2,0,5,3,2,0,0,0,0,0,0,0,0,0,0,0,0,0,0,0,0,0,0,0,0,0
,,Multiracial,14,4,10,0,14,4,10,0,0,0,0,0,0,0,0,0,0,0,0,0,0,0,0,0,0,0,0,0
,Delaware,All Ethnicities,472,176,296,0,446,164,282,0,26,12,14,0,0,0,0,0,1,1,0,0,0,0,0,0,0,0,0,0
,,,,,,,,,,,,,,,,,,,,,,,,,,,,,,
,,,,,,,,,,,,,,,,,,,,,,,,,,,,,,
,,White,356,140,216,0,336,131,205,0,20,9,11,0,0,0,0,0,1,1,0,0,0,0,0,0,0,0,0,0
,,Black,95,32,63,0,90,29,61,0,5,3,2,0,0,0,0,0,0,0,0,0,0,0,0,0,0,0,0,0
,,Hispanic,12,4,8,0,12,4,8,0,0,0,0,0,0,0,0,0,0,0,0,0,0,0,0,0,0,0,0,0
,,Asian,7,0,7,0,6,0,6,0,1,0,1,0,0,0,0,0,0,0,0,0,0,0,0,0,0,0,0,0
,,American Indian/Alaska Native,1,0,1,0,1,0,1,0,0,0,0,0,0,0,0,0,0,0,0,0,0,0,0,0,0,0,0,0
,,Pacific Islander,1,0,1,0,1,0,1,0,0,0,0,0,0,0,0,0,0,0,0,0,0,0,0,0,0,0,0,0
,District of Columbia,All Ethnicities,474,219,255,0,453,212,241,0,20,7,13,0,0,0,0,0,0,0,0,0,1,0,1,0,0,0,0,0
,,White,180,82,98,0,169,77,92,0,10,5,5,0,0,0,0,0,0,0,0,0,1,0,1,0,0,0,0,0
,,Black,244,110,134,0,236,109,127,0,8,1,7,0,0,0,0,0,0,0,0,0,0,0,0,0,0,0,0,0
,,Hispanic,26,17,9,0,25,17,8,0,1,0,1,0,0,0,0,0,0,0,0,0,0,0,0,0,0,0,0,0
,,Asian,17,7,10,0,16,6,10,0,1,1,0,0,0,0,0,0,0,0,0,0,0,0,0,0,0,0,0,0
,,American Indian/Alaska Native,1,0,1,0,1,0,1,0,0,0,0,0,0,0,0,0,0,0,0,0,0,0,0,0,0,0,0,0
,,Pacific Islander,3,1,2,0,3,1,2,0,0,0,0,0,0,0,0,0,0,0,0,0,0,0,0,0,0,0,0,0
,,Multiracial,3,2,1,0,3,2,1,0,0,0,0,0,0,0,0,0,0,0,0,0,0,0,0,0,0,0,0,0
,Florida,All Ethnicities,6207,2482,3725,0,6055,2412,3643,0,131,63,68,0,1,1,0,0,2,1,1,0,19,5,14,0,0,0,0,0
,,White,4261,1673,2588,0,4141,1620,2521,0,100,47,53,0,1,1,0,0,1,0,1,0,19,5,14,0,0,0,0,0
,,Black,788,339,449,0,779,335,444,0,8,3,5,0,0,0,0,0,1,1,0,0,0,0,0,0,0,0,0,0
,,Hispanic,1003,400,603,0,984,391,593,0,19,9,10,0,0,0,0,0,0,0,0,0,0,0,0,0,0,0,0,0
,,Unknown,4,1,3,0,4,1,3,0,0,0,0,0,0,0,0,0,0,0,0,0,0,0,0,0,0,0,0,0
,,Asian,107,48,59,0,104,45,59,0,3,3,0,0,0,0,0,0,0,0,0,0,0,0,0,0,0,0,0,0
,,American Indian/Alaska Native,9,7,2,0,9,7,2,0,0,0,0,0,0,0,0,0,0,0,0,0,0,0,0,0,0,0,0,0
,,Pacific Islander,9,4,5,0,9,4,5,0,0,0,0,0,0,0,0,0,0,0,0,0,0,0,0,0,0,0,0,0
,,Multiracial,26,10,16,0,25,9,16,0,1,1,0,0,0,0,0,0,0,0,0,0,0,0,0,0,0,0,0,0
,Georgia,All Ethnicities,4071,1524,2547,0,3971,1486,2485,0,93,34,59,0,1,1,0,0,2,1,1,0,4,2,2,0,0,0,0,0
,,White,2758,1018,1740,0,2677,987,1690,0,74,27,47,0,1,1,0,0,2,1,1,0,4,2,2,0,0,0,0,0
,,Black,1033,399,634,0,1021,394,627,0,12,5,7,0,0,0,0,0,0,0,0,0,0,0,0,0,0,0,0,0
,,Hispanic,173,70,103,0,167,68,99,0,6,2,4,0,0,0,0,0,0,0,0,0,0,0,0,0,0,0,0,0
,,Unknown,1,1,0,0,1,1,0,0,0,0,0,0,0,0,0,0,0,0,0,0,0,0,0,0,0,0,0,0
,,Asian,77,24,53,0,76,24,52,0,1,0,1,0,0,0,0,0,0,0,0,0,0,0,0,0,0,0,0,0
,,American Indian/Alaska Native,5,2,3,0,5,2,3,0,0,0,0,0,0,0,0,0,0,0,0,0,0,0,0,0,0,0,0,0
,,Pacific Islander,7,4,3,0,7,4,3,0,0,0,0,0,0,0,0,0,0,0,0,0,0,0,0,0,0,0,0,0
,,Multiracial,17,6,11,0,17,6,11,0,0,0,0,0,0,0,0,0,0,0,0,0,0,0,0,0,0,0,0,0
,Hawaii,All Ethnicities,512,217,295,0,494,210,284,0,18,7,11,0,0,0,0,0,0,0,0,0,0,0,0,0,0,0,0,0
,,White,183,86,97,0,174,81,93,0,9,5,4,0,0,0,0,0,0,0,0,0,0,0,0,0,0,0,0,0
,,Black,10,5,5,0,10,5,5,0,0,0,0,0,0,0,0,0,0,0,0,0,0,0,0,0,0,0,0,0
,,Hispanic,16,6,10,0,15,5,10,0,1,1,0,0,0,0,0,0,0,0,0,0,0,0,0,0,0,0,0,0
,,Unknown,2,1,1,0,2,1,1,0,0,0,0,0,0,0,0,0,0,0,0,0,0,0,0,0,0,0,0,0
,,Asian,166,69,97,0,163,68,95,0,3,1,2,0,0,0,0,0,0,0,0,0,0,0,0,0,0,0,0,0
,,American Indian/Alaska Native,2,1,1,0,2,1,1,0,0,0,0,0,0,0,0,0,0,0,0,0,0,0,0,0,0,0,0,0
,,Pacific Islander,79,31,48,0,74,31,43,0,5,0,5,0,0,0,0,0,0,0,0,0,0,0,0,0,0,0,0,0
,,Multiracial,54,18,36,0,54,18,36,0,0,0,0,0,0,0,0,0,0,0,0,0,0,0,0,0,0,0,0,0
,,,,,,,,,,,,,,,,,,,,,,,,,,,,,,
,,,,,,,,,,,,,,,,,,,,,,,,,,,,,,
,Idaho,All Ethnicities,746,292,454,0,718,279,439,0,26,13,13,0,2,0,2,0,0,0,0,0,0,0,0,0,0,0,0,0
,,White,681,268,413,0,656,256,400,0,23,12,11,0,2,0,2,0,0,0,0,0,0,0,0,0,0,0,0,0
,,Black,8,3,5,0,8,3,5,0,0,0,0,0,0,0,0,0,0,0,0,0,0,0,0,0,0,0,0,0
,,Hispanic,38,14,24,0,36,14,22,0,2,0,2,0,0,0,0,0,0,0,0,0,0,0,0,0,0,0,0,0
,,Asian,2,1,1,0,2,1,1,0,0,0,0,0,0,0,0,0,0,0,0,0,0,0,0,0,0,0,0,0
,,American Indian/Alaska Native,10,3,7,0,9,2,7,0,1,1,0,0,0,0,0,0,0,0,0,0,0,0,0,0,0,0,0,0
,,Pacific Islander,3,1,2,0,3,1,2,0,0,0,0,0,0,0,0,0,0,0,0,0,0,0,0,0,0,0,0,0
,,Multiracial,4,2,2,0,4,2,2,0,0,0,0,0,0,0,0,0,0,0,0,0,0,0,0,0,0,0,0,0
,Illinois,All Ethnicities,8361,3526,4835,0,7898,3304,4594,0,438,206,232,0,0,0,0,0,8,3,5,0,6,4,2,0,20,12,8,0
,,White,5228,2127,3101,0,4884,1968,2916,0,331,151,180,0,0,0,0,0,5,2,3,0,3,2,1,0,9,5,4,0
,,Black,1382,636,746,0,1347,615,732,0,31,18,13,0,0,0,0,0,0,0,0,0,0,0,0,0,5,3,2,0
,,Hispanic,1455,653,802,0,1381,616,765,0,66,32,34,0,0,0,0,0,2,1,1,0,3,2,1,0,6,4,2,0
,,Unknown,1,0,1,0,1,0,1,0,0,0,0,0,0,0,0,0,0,0,0,0,0,0,0,0,0,0,0,0
,,Asian,216,84,132,0,209,80,129,0,7,4,3,0,0,0,0,0,1,0,1,0,0,0,0,0,0,0,0,0
,,American Indian/Alaska Native,4,2,2,0,4,2,2,0,0,0,0,0,0,0,0,0,0,0,0,0,0,0,0,0,0,0,0,0
,,Pacific Islander,19,6,13,0,18,6,12,0,1,0,1,0,0,0,0,0,0,0,0,0,0,0,0,0,0,0,0,0
,,Multiracial,56,18,38,0,54,17,37,0,2,1,1,0,0,0,0,0,0,0,0,0,0,0,0,0,0,0,0,0
,Indiana,All Ethnicities,3159,1238,1921,0,3081,1202,1879,0,66,31,35,0,0,0,0,0,1,0,1,0,8,4,4,0,3,1,2,0
,,White,2730,1041,1689,0,2660,1009,1651,0,60,28,32,0,0,0,0,0,1,0,1,0,6,3,3,0,3,1,2,0
,,Black,250,116,134,0,246,114,132,0,2,1,1,0,0,0,0,0,0,0,0,0,2,1,1,0,0,0,0,0
,,Hispanic,137,65,72,0,135,64,71,0,2,1,1,0,0,0,0,0,0,0,0,0,0,0,0,0,0,0,0,0
,,Asian,29,11,18,0,28,10,18,0,1,1,0,0,0,0,0,0,0,0,0,0,0,0,0,0,0,0,0,0
,,American Indian/Alaska Native,1,0,1,0,1,0,1,0,0,0,0,0,0,0,0,0,0,0,0,0,0,0,0,0,0,0,0,0
,,Pacific Islander,3,1,2,0,2,1,1,0,1,0,1,0,0,0,0,0,0,0,0,0,0,0,0,0,0,0,0,0
,,Multiracial,9,4,5,0,9,4,5,0,0,0,0,0,0,0,0,0,0,0,0,0,0,0,0,0,0,0,0,0
,Iowa,All Ethnicities,1876,768,1108,0,1819,740,1079,0,51,25,26,0,0,0,0,0,2,1,1,0,5,3,2,0,1,0,1,0
,,White,1771,713,1058,0,1716,687,1029,0,49,23,26,0,0,0,0,0,2,1,1,0,5,3,2,0,1,0,1,0
,,Black,47,23,24,0,47,23,24,0,0,0,0,0,0,0,0,0,0,0,0,0,0,0,0,0,0,0,0,0
,,Hispanic,44,25,19,0,42,23,19,0,2,2,0,0,0,0,0,0,0,0,0,0,0,0,0,0,0,0,0,0
,,Asian,8,3,5,0,8,3,5,0,0,0,0,0,0,0,0,0,0,0,0,0,0,0,0,0,0,0,0,0
,,American Indian/Alaska Native,4,4,0,0,4,4,0,0,0,0,0,0,0,0,0,0,0,0,0,0,0,0,0,0,0,0,0,0
,,Multiracial,2,0,2,0,2,0,2,0,0,0,0,0,0,0,0,0,0,0,0,0,0,0,0,0,0,0,0,0
,Kansas,All Ethnicities,1088,431,657,0,1053,408,645,0,30,18,12,0,0,0,0,0,1,0,1,0,5,5,0,0,0,0,0,0
,,White,948,383,565,0,916,361,555,0,27,17,10,0,0,0,0,0,1,0,1,0,5,5,0,0,0,0,0,0
,,Black,59,22,37,0,58,21,37,0,1,1,0,0,0,0,0,0,0,0,0,0,0,0,0,0,0,0,0,0
,,Hispanic,58,21,37,0,57,21,36,0,1,0,1,0,0,0,0,0,0,0,0,0,0,0,0,0,0,0,0,0
,,Asian,9,2,7,0,9,2,7,0,0,0,0,0,0,0,0,0,0,0,0,0,0,0,0,0,0,0,0,0
,,American Indian/Alaska Native,4,1,3,0,4,1,3,0,0,0,0,0,0,0,0,0,0,0,0,0,0,0,0,0,0,0,0,0
,,Pacific Islander,3,0,3,0,3,0,3,0,0,0,0,0,0,0,0,0,0,0,0,0,0,0,0,0,0,0,0,0
,,Multiracial,7,2,5,0,6,2,4,0,1,0,1,0,0,0,0,0,0,0,0,0,0,0,0,0,0,0,0,0
,Kentucky,All Ethnicities,1829,706,1123,0,1787,684,1103,0,40,21,19,0,0,0,0,0,2,1,1,0,1,0,1,0,0,0,0,0
,,,,,,,,,,,,,,,,,,,,,,,,,,,,,,
,,,,,,,,,,,,,,,,,,,,,,,,,,,,,,
,,White,1669,630,1039,0,1629,610,1019,0,38,19,19,0,0,0,0,0,2,1,1,0,1,0,1,0,0,0,0,0
,,Black,117,56,61,0,116,55,61,0,1,1,0,0,0,0,0,0,0,0,0,0,0,0,0,0,0,0,0,0
,,Hispanic,24,7,17,0,23,6,17,0,1,1,0,0,0,0,0,0,0,0,0,0,0,0,0,0,0,0,0,0
,,Asian,13,9,4,0,13,9,4,0,0,0,0,0,0,0,0,0,0,0,0,0,0,0,0,0,0,0,0,0
,,Pacific Islander,2,1,1,0,2,1,1,0,0,0,0,0,0,0,0,0,0,0,0,0,0,0,0,0,0,0,0,0
,,Multiracial,4,3,1,0,4,3,1,0,0,0,0,0,0,0,0,0,0,0,0,0,0,0,0,0,0,0,0,0
,Louisiana,All Ethnicities,1906,781,1125,0,1863,757,1106,0,39,22,17,0,0,0,0,0,0,0,0,0,2,1,1,0,2,1,1,0
,,White,1263,493,770,0,1236,477,759,0,23,14,9,0,0,0,0,0,0,0,0,0,2,1,1,0,2,1,1,0
,,Black,561,253,308,0,550,248,302,0,11,5,6,0,0,0,0,0,0,0,0,0,0,0,0,0,0,0,0,0
,,Hispanic,41,20,21,0,38,18,20,0,3,2,1,0,0,0,0,0,0,0,0,0,0,0,0,0,0,0,0,0
,,Asian,30,12,18,0,29,12,17,0,1,0,1,0,0,0,0,0,0,0,0,0,0,0,0,0,0,0,0,0
,,American Indian/Alaska Native,5,1,4,0,4,0,4,0,1,1,0,0,0,0,0,0,0,0,0,0,0,0,0,0,0,0,0,0
,,Pacific Islander,1,0,1,0,1,0,1,0,0,0,0,0,0,0,0,0,0,0,0,0,0,0,0,0,0,0,0,0
,,Multiracial,5,2,3,0,5,2,3,0,0,0,0,0,0,0,0,0,0,0,0,0,0,0,0,0,0,0,0,0
,Maine,All Ethnicities,836,341,495,0,761,300,461,0,65,36,29,0,0,0,0,0,1,0,1,0,10,5,5,0,0,0,0,0
,,White,800,321,479,0,729,283,446,0,61,33,28,0,0,0,0,0,1,0,1,0,10,5,5,0,0,0,0,0
,,Black,18,10,8,0,16,9,7,0,2,1,1,0,0,0,0,0,0,0,0,0,0,0,0,0,0,0,0,0
,,Hispanic,10,5,5,0,9,4,5,0,1,1,0,0,0,0,0,0,0,0,0,0,0,0,0,0,0,0,0,0
,,Asian,5,3,2,0,4,2,2,0,1,1,0,0,0,0,0,0,0,0,0,0,0,0,0,0,0,0,0,0
,,American Indian/Alaska Native,1,1,0,0,1,1,0,0,0,0,0,0,0,0,0,0,0,0,0,0,0,0,0,0,0,0,0,0
,,Multiracial,2,1,1,0,2,1,1,0,0,0,0,0,0,0,0,0,0,0,0,0,0,0,0,0,0,0,0,0
,Maryland,All Ethnicities,4371,1714,2657,0,4120,1567,2553,0,248,146,102,0,0,0,0,0,1,0,1,0,3,1,2,0,0,0,0,0
,,White,2557,1007,1550,0,2371,897,1474,0,183,109,74,0,0,0,0,0,0,0,0,0,3,1,2,0,0,0,0,0
,,Black,1463,564,899,0,1415,537,878,0,48,27,21,0,0,0,0,0,1,0,1,0,0,0,0,0,0,0,0,0
,,Hispanic,166,77,89,0,157,74,83,0,9,3,6,0,0,0,0,0,0,0,0,0,0,0,0,0,0,0,0,0
,,Unknown,3,1,2,0,3,1,2,0,0,0,0,0,0,0,0,0,0,0,0,0,0,0,0,0,0,0,0,0
,,Asian,121,40,81,0,113,33,80,0,8,7,1,0,0,0,0,0,0,0,0,0,0,0,0,0,0,0,0,0
,,American Indian/Alaska Native,10,1,9,0,10,1,9,0,0,0,0,0,0,0,0,0,0,0,0,0,0,0,0,0,0,0,0,0
,,Pacific Islander,22,10,12,0,22,10,12,0,0,0,0,0,0,0,0,0,0,0,0,0,0,0,0,0,0,0,0,0
,,Multiracial,29,14,15,0,29,14,15,0,0,0,0,0,0,0,0,0,0,0,0,0,0,0,0,0,0,0,0,0
,Massachusetts,All Ethnicities,4230,1743,2487,0,3892,1572,2320,0,302,150,152,0,0,0,0,0,1,0,1,0,34,21,13,0,1,0,1,0
,,White,3538,1446,2092,0,3234,1296,1938,0,268,129,139,0,0,0,0,0,1,0,1,0,34,21,13,0,1,0,1,0
,,Black,253,105,148,0,246,99,147,0,7,6,1,0,0,0,0,0,0,0,0,0,0,0,0,0,0,0,0,0
,,Hispanic,303,134,169,0,284,124,160,0,19,10,9,0,0,0,0,0,0,0,0,0,0,0,0,0,0,0,0,0
,,Asian,111,47,64,0,104,43,61,0,7,4,3,0,0,0,0,0,0,0,0,0,0,0,0,0,0,0,0,0
,,American Indian/Alaska Native,2,1,1,0,2,1,1,0,0,0,0,0,0,0,0,0,0,0,0,0,0,0,0,0,0,0,0,0
,,Pacific Islander,4,2,2,0,4,2,2,0,0,0,0,0,0,0,0,0,0,0,0,0,0,0,0,0,0,0,0,0
,,Multiracial,19,8,11,0,18,7,11,0,1,1,0,0,0,0,0,0,0,0,0,0,0,0,0,0,0,0,0,0
,Michigan,All Ethnicities,6589,2646,3943,0,6366,2540,3826,0,214,102,112,0,1,0,1,0,0,0,0,0,7,3,4,0,1,1,0,0
,,White,5372,2138,3234,0,5175,2049,3126,0,189,86,103,0,1,0,1,0,0,0,0,0,7,3,4,0,0,0,0,0
,,Black,871,359,512,0,855,350,505,0,15,8,7,0,0,0,0,0,0,0,0,0,0,0,0,0,1,1,0,0
,,,,,,,,,,,,,,,,,,,,,,,,,,,,,,
,,,,,,,,,,,,,,,,,,,,,,,,,,,,,,
,,Hispanic,207,95,112,0,198,88,110,0,9,7,2,0,0,0,0,0,0,0,0,0,0,0,0,0,0,0,0,0
,,Unknown,3,1,2,0,3,1,2,0,0,0,0,0,0,0,0,0,0,0,0,0,0,0,0,0,0,0,0,0
,,Asian,86,32,54,0,85,31,54,0,1,1,0,0,0,0,0,0,0,0,0,0,0,0,0,0,0,0,0,0
,,American Indian/Alaska Native,17,8,9,0,17,8,9,0,0,0,0,0,0,0,0,0,0,0,0,0,0,0,0,0,0,0,0,0
,,Pacific Islander,10,5,5,0,10,5,5,0,0,0,0,0,0,0,0,0,0,0,0,0,0,0,0,0,0,0,0,0
,,Multiracial,23,8,15,0,23,8,15,0,0,0,0,0,0,0,0,0,0,0,0,0,0,0,0,0,0,0,0,0
,Minnesota,All Ethnicities,5078,2147,2931,0,4832,2032,2800,0,225,106,119,0,3,0,3,0,20,8,12,0,11,7,4,0,4,2,2,0
,,White,4551,1898,2653,0,4324,1795,2529,0,208,95,113,0,3,0,3,0,18,7,11,0,10,7,3,0,3,1,2,0
,,Black,201,97,104,0,195,94,101,0,5,2,3,0,0,0,0,0,1,1,0,0,0,0,0,0,1,1,0,0
,,Hispanic,118,63,55,0,110,57,53,0,8,6,2,0,0,0,0,0,0,0,0,0,0,0,0,0,0,0,0,0
,,Unknown,5,2,3,0,4,2,2,0,0,0,0,0,0,0,0,0,0,0,0,0,1,0,1,0,0,0,0,0
,,Asian,107,50,57,0,106,50,56,0,1,0,1,0,0,0,0,0,1,0,1,0,0,0,0,0,0,0,0,0
,,American Indian/Alaska Native,76,30,46,0,74,28,46,0,2,2,0,0,0,0,0,0,0,0,0,0,0,0,0,0,0,0,0,0
,,Pacific Islander,4,1,3,0,4,1,3,0,0,0,0,0,0,0,0,0,0,0,0,0,0,0,0,0,0,0,0,0
,,Multiracial,16,6,10,0,15,5,10,0,1,1,0,0,0,0,0,0,0,0,0,0,0,0,0,0,0,0,0,0
,Mississippi,All Ethnicities,1014,393,621,0,978,384,594,0,32,8,24,0,1,0,1,0,0,0,0,0,3,1,2,0,0,0,0,0
,,White,745,286,459,0,712,278,434,0,30,8,22,0,1,0,1,0,0,0,0,0,2,0,2,0,0,0,0,0
,,Black,249,102,147,0,248,102,146,0,1,0,1,0,0,0,0,0,0,0,0,0,0,0,0,0,0,0,0,0
,,Hispanic,8,1,7,0,7,0,7,0,0,0,0,0,0,0,0,0,0,0,0,0,1,1,0,0,0,0,0,0
,,Asian,9,4,5,0,9,4,5,0,0,0,0,0,0,0,0,0,0,0,0,0,0,0,0,0,0,0,0,0
,,American Indian/Alaska Native,1,0,1,0,1,0,1,0,0,0,0,0,0,0,0,0,0,0,0,0,0,0,0,0,0,0,0,0
,,Multiracial,2,0,2,0,1,0,1,0,1,0,1,0,0,0,0,0,0,0,0,0,0,0,0,0,0,0,0,0
,Missouri,All Ethnicities,2505,997,1508,0,2439,964,1475,0,62,30,32,0,0,0,0,0,0,0,0,0,4,3,1,0,0,0,0,0
,,White,2154,858,1296,0,2094,827,1267,0,56,28,28,0,0,0,0,0,0,0,0,0,4,3,1,0,0,0,0,0
,,Black,257,109,148,0,254,107,147,0,3,2,1,0,0,0,0,0,0,0,0,0,0,0,0,0,0,0,0,0
,,Hispanic,48,17,31,0,46,17,29,0,2,0,2,0,0,0,0,0,0,0,0,0,0,0,0,0,0,0,0,0
,,Asian,30,8,22,0,29,8,21,0,1,0,1,0,0,0,0,0,0,0,0,0,0,0,0,0,0,0,0,0
,,American Indian/Alaska Native,5,1,4,0,5,1,4,0,0,0,0,0,0,0,0,0,0,0,0,0,0,0,0,0,0,0,0,0
,,Pacific Islander,2,1,1,0,2,1,1,0,0,0,0,0,0,0,0,0,0,0,0,0,0,0,0,0,0,0,0,0
,,Multiracial,9,3,6,0,9,3,6,0,0,0,0,0,0,0,0,0,0,0,0,0,0,0,0,0,0,0,0,0
,Montana,All Ethnicities,560,218,342,0,535,202,333,0,23,14,9,0,1,1,0,0,0,0,0,0,1,1,0,0,0,0,0,0
,,White,510,203,307,0,485,187,298,0,23,14,9,0,1,1,0,0,0,0,0,0,1,1,0,0,0,0,0,0
,,Black,2,0,2,0,2,0,2,0,0,0,0,0,0,0,0,0,0,0,0,0,0,0,0,0,0,0,0,0
,,Hispanic,6,4,2,0,6,4,2,0,0,0,0,0,0,0,0,0,0,0,0,0,0,0,0,0,0,0,0,0
,,American Indian/Alaska Native,41,10,31,0,41,10,31,0,0,0,0,0,0,0,0,0,0,0,0,0,0,0,0,0,0,0,0,0
,,Multiracial,1,1,0,0,1,1,0,0,0,0,0,0,0,0,0,0,0,0,0,0,0,0,0,0,0,0,0,0
,Nebraska,All Ethnicities,1029,423,606,0,983,399,584,0,40,19,21,0,0,0,0,0,0,0,0,0,6,5,1,0,0,0,0,0
,,White,929,381,548,0,883,357,526,0,40,19,21,0,0,0,0,0,0,0,0,0,6,5,1,0,0,0,0,0
,,Black,38,15,23,0,38,15,23,0,0,0,0,0,0,0,0,0,0,0,0,0,0,0,0,0,0,0,0,0
,,Hispanic,50,24,26,0,50,24,26,0,0,0,0,0,0,0,0,0,0,0,0,0,0,0,0,0,0,0,0,0
,,Asian,4,1,3,0,4,1,3,0,0,0,0,0,0,0,0,0,0,0,0,0,0,0,0,0,0,0,0,0
,,,,,,,,,,,,,,,,,,,,,,,,,,,,,,
,,,,,,,,,,,,,,,,,,,,,,,,,,,,,,
,,American Indian/Alaska Native,5,1,4,0,5,1,4,0,0,0,0,0,0,0,0,0,0,0,0,0,0,0,0,0,0,0,0,0
,,Multiracial,3,1,2,0,3,1,2,0,0,0,0,0,0,0,0,0,0,0,0,0,0,0,0,0,0,0,0,0
,Nevada,All Ethnicities,980,426,554,0,933,400,533,0,39,19,20,0,0,0,0,0,0,0,0,0,8,7,1,0,0,0,0,0
,,White,692,296,396,0,662,281,381,0,25,11,14,0,0,0,0,0,0,0,0,0,5,4,1,0,0,0,0,0
,,Black,82,37,45,0,82,37,45,0,0,0,0,0,0,0,0,0,0,0,0,0,0,0,0,0,0,0,0,0
,,Hispanic,126,51,75,0,115,46,69,0,10,4,6,0,0,0,0,0,0,0,0,0,1,1,0,0,0,0,0,0
,,Asian,48,26,22,0,45,23,22,0,1,1,0,0,0,0,0,0,0,0,0,0,2,2,0,0,0,0,0,0
,,American Indian/Alaska Native,10,6,4,0,9,5,4,0,1,1,0,0,0,0,0,0,0,0,0,0,0,0,0,0,0,0,0,0
,,Pacific Islander,8,3,5,0,8,3,5,0,0,0,0,0,0,0,0,0,0,0,0,0,0,0,0,0,0,0,0,0
,,Multiracial,14,7,7,0,12,5,7,0,2,2,0,0,0,0,0,0,0,0,0,0,0,0,0,0,0,0,0,0
,New Hampshire,All Ethnicities,894,373,521,0,830,334,496,0,59,35,24,0,0,0,0,0,0,0,0,0,5,4,1,0,0,0,0,0
,,White,859,355,504,0,796,317,479,0,58,34,24,0,0,0,0,0,0,0,0,0,5,4,1,0,0,0,0,0
,,Black,7,3,4,0,7,3,4,0,0,0,0,0,0,0,0,0,0,0,0,0,0,0,0,0,0,0,0,0
,,Hispanic,19,10,9,0,19,10,9,0,0,0,0,0,0,0,0,0,0,0,0,0,0,0,0,0,0,0,0,0
,,Asian,8,5,3,0,7,4,3,0,1,1,0,0,0,0,0,0,0,0,0,0,0,0,0,0,0,0,0,0
,,Multiracial,1,0,1,0,1,0,1,0,0,0,0,0,0,0,0,0,0,0,0,0,0,0,0,0,0,0,0,0
,New Jersey,All Ethnicities,5532,2175,3357,0,5304,2072,3232,0,224,100,124,0,0,0,0,0,0,0,0,0,4,3,1,0,0,0,0,0
,,White,3588,1389,2199,0,3403,1308,2095,0,182,79,103,0,0,0,0,0,0,0,0,0,3,2,1,0,0,0,0,0
,,Black,782,318,464,0,777,316,461,0,5,2,3,0,0,0,0,0,0,0,0,0,0,0,0,0,0,0,0,0
,,Hispanic,834,343,491,0,804,328,476,0,29,14,15,0,0,0,0,0,0,0,0,0,1,1,0,0,0,0,0,0
,,Unknown,1,1,0,0,1,1,0,0,0,0,0,0,0,0,0,0,0,0,0,0,0,0,0,0,0,0,0,0
,,Asian,281,105,176,0,273,100,173,0,8,5,3,0,0,0,0,0,0,0,0,0,0,0,0,0,0,0,0,0
,,American Indian/Alaska Native,6,1,5,0,6,1,5,0,0,0,0,0,0,0,0,0,0,0,0,0,0,0,0,0,0,0,0,0
,,Pacific Islander,14,6,8,0,14,6,8,0,0,0,0,0,0,0,0,0,0,0,0,0,0,0,0,0,0,0,0,0
,,Multiracial,26,12,14,0,26,12,14,0,0,0,0,0,0,0,0,0,0,0,0,0,0,0,0,0,0,0,0,0
,New Mexico,All Ethnicities,869,360,509,0,836,345,491,0,32,14,18,0,0,0,0,0,0,0,0,0,0,0,0,0,1,1,0,0
,,White,435,193,242,0,417,184,233,0,17,8,9,0,0,0,0,0,0,0,0,0,0,0,0,0,1,1,0,0
,,Black,13,3,10,0,13,3,10,0,0,0,0,0,0,0,0,0,0,0,0,0,0,0,0,0,0,0,0,0
,,Hispanic,359,149,210,0,349,145,204,0,10,4,6,0,0,0,0,0,0,0,0,0,0,0,0,0,0,0,0,0
,,Asian,7,3,4,0,6,2,4,0,1,1,0,0,0,0,0,0,0,0,0,0,0,0,0,0,0,0,0,0
,,American Indian/Alaska Native,44,7,37,0,41,7,34,0,3,0,3,0,0,0,0,0,0,0,0,0,0,0,0,0,0,0,0,0
,,Pacific Islander,1,0,1,0,1,0,1,0,0,0,0,0,0,0,0,0,0,0,0,0,0,0,0,0,0,0,0,0
,,Multiracial,10,5,5,0,9,4,5,0,1,1,0,0,0,0,0,0,0,0,0,0,0,0,0,0,0,0,0,0
,New York,All Ethnicities,11562,4893,6669,0,10641,4451,6190,0,904,432,472,0,0,0,0,0,2,0,2,0,16,10,6,0,0,0,0,0
,,White,7241,3090,4151,0,6602,2781,3821,0,623,300,323,0,0,0,0,0,2,0,2,0,15,9,6,0,0,0,0,0
,,Black,1678,723,955,0,1611,692,919,0,67,31,36,0,0,0,0,0,0,0,0,0,0,0,0,0,0,0,0,0
,,Hispanic,2035,852,1183,0,1887,782,1105,0,147,69,78,0,0,0,0,0,0,0,0,0,1,1,0,0,0,0,0,0
,,Unknown,2,1,1,0,2,1,1,0,0,0,0,0,0,0,0,0,0,0,0,0,0,0,0,0,0,0,0,0
,,Asian,447,161,286,0,400,139,261,0,47,22,25,0,0,0,0,0,0,0,0,0,0,0,0,0,0,0,0,0
,,American Indian/Alaska Native,18,6,12,0,16,5,11,0,2,1,1,0,0,0,0,0,0,0,0,0,0,0,0,0,0,0,0,0
,,Pacific Islander,34,13,21,0,32,12,20,0,2,1,1,0,0,0,0,0,0,0,0,0,0,0,0,0,0,0,0,0
,,,,,,,,,,,,,,,,,,,,,,,,,,,,,,
,,,,,,,,,,,,,,,,,,,,,,,,,,,,,,
,,Multiracial,107,47,60,0,91,39,52,0,16,8,8,0,0,0,0,0,0,0,0,0,0,0,0,0,0,0,0,0
,North Carolina,All Ethnicities,3923,1564,2359,0,3777,1497,2280,0,136,61,75,0,1,1,0,0,0,0,0,0,9,5,4,0,0,0,0,0
,,White,2846,1117,1729,0,2724,1058,1666,0,112,53,59,0,1,1,0,0,0,0,0,0,9,5,4,0,0,0,0,0
,,Black,861,365,496,0,846,361,485,0,15,4,11,0,0,0,0,0,0,0,0,0,0,0,0,0,0,0,0,0
,,Hispanic,105,46,59,0,102,45,57,0,3,1,2,0,0,0,0,0,0,0,0,0,0,0,0,0,0,0,0,0
,,Asian,33,14,19,0,30,12,18,0,3,2,1,0,0,0,0,0,0,0,0,0,0,0,0,0,0,0,0,0
,,American Indian/Alaska Native,47,11,36,0,45,11,34,0,2,0,2,0,0,0,0,0,0,0,0,0,0,0,0,0,0,0,0,0
,,Pacific Islander,3,1,2,0,3,1,2,0,0,0,0,0,0,0,0,0,0,0,0,0,0,0,0,0,0,0,0,0
,,Multiracial,28,10,18,0,27,9,18,0,1,1,0,0,0,0,0,0,0,0,0,0,0,0,0,0,0,0,0,0
,North Dakota,All Ethnicities,565,223,342,0,545,213,332,0,19,9,10,0,0,0,0,0,1,0,1,0,0,0,0,0,1,1,0,0
,,White,485,189,296,0,465,179,286,0,19,9,10,0,0,0,0,0,1,0,1,0,0,0,0,0,1,1,0,0
,,Black,5,2,3,0,5,2,3,0,0,0,0,0,0,0,0,0,0,0,0,0,0,0,0,0,0,0,0,0
,,Hispanic,9,6,3,0,9,6,3,0,0,0,0,0,0,0,0,0,0,0,0,0,0,0,0,0,0,0,0,0
,,Asian,3,0,3,0,3,0,3,0,0,0,0,0,0,0,0,0,0,0,0,0,0,0,0,0,0,0,0,0
,,American Indian/Alaska Native,59,25,34,0,59,25,34,0,0,0,0,0,0,0,0,0,0,0,0,0,0,0,0,0,0,0,0,0
,,Pacific Islander,1,0,1,0,1,0,1,0,0,0,0,0,0,0,0,0,0,0,0,0,0,0,0,0,0,0,0,0
,,Multiracial,3,1,2,0,3,1,2,0,0,0,0,0,0,0,0,0,0,0,0,0,0,0,0,0,0,0,0,0
,Ohio,All Ethnicities,7057,2793,4264,0,6822,2697,4125,0,223,89,134,0,1,1,0,0,3,1,2,0,9,5,4,0,0,0,0,0
,,White,6012,2384,3628,0,5790,2289,3501,0,210,88,122,0,1,1,0,0,3,1,2,0,9,5,4,0,0,0,0,0
,,Black,837,333,504,0,829,332,497,0,8,1,7,0,0,0,0,0,0,0,0,0,0,0,0,0,0,0,0,0
,,Hispanic,113,42,71,0,109,42,67,0,4,0,4,0,0,0,0,0,0,0,0,0,0,0,0,0,0,0,0,0
,,Unknown,1,0,1,0,1,0,1,0,0,0,0,0,0,0,0,0,0,0,0,0,0,0,0,0,0,0,0,0
,,Asian,51,22,29,0,51,22,29,0,0,0,0,0,0,0,0,0,0,0,0,0,0,0,0,0,0,0,0,0
,,American Indian/Alaska Native,3,1,2,0,3,1,2,0,0,0,0,0,0,0,0,0,0,0,0,0,0,0,0,0,0,0,0,0
,,Pacific Islander,4,1,3,0,4,1,3,0,0,0,0,0,0,0,0,0,0,0,0,0,0,0,0,0,0,0,0,0
,,Multiracial,36,10,26,0,35,10,25,0,1,0,1,0,0,0,0,0,0,0,0,0,0,0,0,0,0,0,0,0
,Oklahoma,All Ethnicities,1273,517,756,0,1240,499,741,0,30,16,14,0,0,0,0,0,0,0,0,0,3,2,1,0,0,0,0,0
,,White,1045,427,618,0,1017,413,604,0,25,12,13,0,0,0,0,0,0,0,0,0,3,2,1,0,0,0,0,0
,,Black,87,33,54,0,86,32,54,0,1,1,0,0,0,0,0,0,0,0,0,0,0,0,0,0,0,0,0,0
,,Hispanic,56,29,27,0,53,27,26,0,3,2,1,0,0,0,0,0,0,0,0,0,0,0,0,0,0,0,0,0
,,Asian,8,5,3,0,8,5,3,0,0,0,0,0,0,0,0,0,0,0,0,0,0,0,0,0,0,0,0,0
,,American Indian/Alaska Native,66,17,49,0,65,16,49,0,1,1,0,0,0,0,0,0,0,0,0,0,0,0,0,0,0,0,0,0
,,Pacific Islander,4,2,2,0,4,2,2,0,0,0,0,0,0,0,0,0,0,0,0,0,0,0,0,0,0,0,0,0
,,Multiracial,7,4,3,0,7,4,3,0,0,0,0,0,0,0,0,0,0,0,0,0,0,0,0,0,0,0,0,0
,Oregon,All Ethnicities,1782,696,1086,0,1728,667,1061,0,42,20,22,0,4,3,1,0,0,0,0,0,8,6,2,0,0,0,0,0
,,White,1589,616,973,0,1539,588,951,0,38,19,19,0,4,3,1,0,0,0,0,0,8,6,2,0,0,0,0,0
,,Black,21,11,10,0,21,11,10,0,0,0,0,0,0,0,0,0,0,0,0,0,0,0,0,0,0,0,0,0
,,Hispanic,97,43,54,0,94,42,52,0,3,1,2,0,0,0,0,0,0,0,0,0,0,0,0,0,0,0,0,0
,,Asian,42,14,28,0,42,14,28,0,0,0,0,0,0,0,0,0,0,0,0,0,0,0,0,0,0,0,0,0
,,American Indian/Alaska Native,9,3,6,0,9,3,6,0,0,0,0,0,0,0,0,0,0,0,0,0,0,0,0,0,0,0,0,0
,,Pacific Islander,12,5,7,0,12,5,7,0,0,0,0,0,0,0,0,0,0,0,0,0,0,0,0,0,0,0,0,0
,,,,,,,,,,,,,,,,,,,,,,,,,,,,,,
,,,,,,,,,,,,,,,,,,,,,,,,,,,,,,
,,Multiracial,12,4,8,0,11,4,7,0,1,0,1,0,0,0,0,0,0,0,0,0,0,0,0,0,0,0,0,0
,Pennsylvania,All Ethnicities,7141,2884,4257,0,6572,2634,3938,0,554,239,315,0,0,0,0,0,4,2,2,0,12,10,2,0,1,0,1,0
,,White,6036,2422,3614,0,5503,2190,3313,0,521,223,298,0,0,0,0,0,4,2,2,0,9,8,1,0,1,0,1,0
,,Black,690,297,393,0,676,288,388,0,14,9,5,0,0,0,0,0,0,0,0,0,0,0,0,0,0,0,0,0
,,Hispanic,271,104,167,0,256,99,157,0,12,3,9,0,0,0,0,0,0,0,0,0,3,2,1,0,0,0,0,0
,,Asian,108,42,66,0,102,39,63,0,6,3,3,0,0,0,0,0,0,0,0,0,0,0,0,0,0,0,0,0
,,American Indian/Alaska Native,3,2,1,0,3,2,1,0,0,0,0,0,0,0,0,0,0,0,0,0,0,0,0,0,0,0,0,0
,,Pacific Islander,11,7,4,0,11,7,4,0,0,0,0,0,0,0,0,0,0,0,0,0,0,0,0,0,0,0,0,0
,,Multiracial,22,10,12,0,21,9,12,0,1,1,0,0,0,0,0,0,0,0,0,0,0,0,0,0,0,0,0,0
,Puerto Rico,All Ethnicities,858,353,505,0,816,332,484,0,41,20,21,0,0,0,0,0,1,0,1,0,1,1,0,0,0,0,0,0
,,White,43,14,29,0,42,13,29,0,0,0,0,0,0,0,0,0,0,0,0,0,1,1,0,0,0,0,0,0
,,Black,5,1,4,0,5,1,4,0,0,0,0,0,0,0,0,0,0,0,0,0,0,0,0,0,0,0,0,0
,,Hispanic,788,326,462,0,747,306,441,0,41,20,21,0,0,0,0,0,1,0,1,0,0,0,0,0,0,0,0,0
,,Unknown,1,1,0,0,1,1,0,0,0,0,0,0,0,0,0,0,0,0,0,0,0,0,0,0,0,0,0,0
,,Asian,1,0,1,0,1,0,1,0,0,0,0,0,0,0,0,0,0,0,0,0,0,0,0,0,0,0,0,0
,,Multiracial,20,11,9,0,20,11,9,0,0,0,0,0,0,0,0,0,0,0,0,0,0,0,0,0,0,0,0,0
,Rhode Island,All Ethnicities,727,281,446,0,686,259,427,0,37,19,18,0,0,0,0,0,0,0,0,0,4,3,1,0,0,0,0,0
,,White,614,229,385,0,578,210,368,0,32,16,16,0,0,0,0,0,0,0,0,0,4,3,1,0,0,0,0,0
,,Black,37,13,24,0,36,13,23,0,1,0,1,0,0,0,0,0,0,0,0,0,0,0,0,0,0,0,0,0
,,Hispanic,59,29,30,0,55,26,29,0,4,3,1,0,0,0,0,0,0,0,0,0,0,0,0,0,0,0,0,0
,,Asian,10,5,5,0,10,5,5,0,0,0,0,0,0,0,0,0,0,0,0,0,0,0,0,0,0,0,0,0
,,American Indian/Alaska Native,5,4,1,0,5,4,1,0,0,0,0,0,0,0,0,0,0,0,0,0,0,0,0,0,0,0,0,0
,,Pacific Islander,1,0,1,0,1,0,1,0,0,0,0,0,0,0,0,0,0,0,0,0,0,0,0,0,0,0,0,0
,,Multiracial,1,1,0,0,1,1,0,0,0,0,0,0,0,0,0,0,0,0,0,0,0,0,0,0,0,0,0,0
,South Carolina,All Ethnicities,1724,639,1085,0,1682,619,1063,0,38,16,22,0,0,0,0,0,0,0,0,0,4,4,0,0,0,0,0,0
,,White,1305,479,826,0,1273,464,809,0,28,11,17,0,0,0,0,0,0,0,0,0,4,4,0,0,0,0,0,0
,,Black,352,137,215,0,345,133,212,0,7,4,3,0,0,0,0,0,0,0,0,0,0,0,0,0,0,0,0,0
,,Hispanic,30,10,20,0,28,10,18,0,2,0,2,0,0,0,0,0,0,0,0,0,0,0,0,0,0,0,0,0
,,Unknown,2,2,0,0,2,2,0,0,0,0,0,0,0,0,0,0,0,0,0,0,0,0,0,0,0,0,0,0
,,Asian,20,8,12,0,19,7,12,0,1,1,0,0,0,0,0,0,0,0,0,0,0,0,0,0,0,0,0,0
,,American Indian/Alaska Native,3,2,1,0,3,2,1,0,0,0,0,0,0,0,0,0,0,0,0,0,0,0,0,0,0,0,0,0
,,Pacific Islander,5,0,5,0,5,0,5,0,0,0,0,0,0,0,0,0,0,0,0,0,0,0,0,0,0,0,0,0
,,Multiracial,7,1,6,0,7,1,6,0,0,0,0,0,0,0,0,0,0,0,0,0,0,0,0,0,0,0,0,0
,South Dakota,All Ethnicities,554,230,324,0,536,220,316,0,18,10,8,0,0,0,0,0,1,1,0,0,0,0,0,0,0,0,0,0
,,White,497,207,290,0,481,198,283,0,16,9,7,0,0,0,0,0,1,1,0,0,0,0,0,0,0,0,0,0
,,Black,1,1,0,0,1,1,0,0,0,0,0,0,0,0,0,0,0,0,0,0,0,0,0,0,0,0,0,0
,,Hispanic,13,4,9,0,13,4,9,0,0,0,0,0,0,0,0,0,0,0,0,0,0,0,0,0,0,0,0,0
,,Asian,2,1,1,0,2,1,1,0,0,0,0,0,0,0,0,0,0,0,0,0,0,0,0,0,0,0,0,0
,,American Indian/Alaska Native,34,15,19,0,32,14,18,0,2,1,1,0,0,0,0,0,0,0,0,0,0,0,0,0,0,0,0,0
,,Multiracial,7,2,5,0,7,2,5,0,0,0,0,0,0,0,0,0,0,0,0,0,0,0,0,0,0,0,0,0
,State unassigned,All Ethnicities,4658,2244,2413,1,4335,2062,2272,1,286,157,129,0,6,4,2,0,4,1,3,0,28,20,8,0,1,1,0,0
,,,,,,,,,,,,,,,,,,,,,,,,,,,,,,
,,,,,,,,,,,,,,,,,,,,,,,,,,,,,,
,,White,1815,916,899,0,1617,798,819,0,168,98,70,0,6,4,2,0,2,0,2,0,22,16,6,0,0,0,0,0
,,Black,402,221,181,0,386,213,173,0,16,8,8,0,0,0,0,0,1,0,1,0,0,0,0,0,0,0,0,0
,,Hispanic,1532,686,846,0,1450,644,806,0,79,39,40,0,0,0,0,0,0,0,0,0,2,2,0,0,1,1,0,0
,,Unknown,74,27,46,1,72,27,44,1,2,0,2,0,0,0,0,0,1,1,0,0,0,0,0,0,0,0,0,0
,,Asian,683,321,362,0,665,311,354,0,15,9,6,0,0,0,0,0,0,0,0,0,3,1,2,0,0,0,0,0
,,American Indian/Alaska Native,11,3,8,0,10,3,7,0,1,0,1,0,0,0,0,0,0,0,0,0,0,0,0,0,0,0,0,0
,,Pacific Islander,98,47,51,0,95,46,49,0,2,0,2,0,0,0,0,0,0,0,0,0,1,1,0,0,0,0,0,0
,,Multiracial,43,23,20,0,40,20,20,0,3,3,0,0,0,0,0,0,0,0,0,0,0,0,0,0,0,0,0,0
,Tennessee,All Ethnicities,2837,1082,1755,0,2770,1047,1723,0,63,33,30,0,0,0,0,0,1,0,1,0,4,2,2,0,0,0,0,0
,,White,2262,838,1424,0,2209,813,1396,0,50,24,26,0,0,0,0,0,1,0,1,0,3,1,2,0,0,0,0,0
,,Black,471,195,276,0,461,188,273,0,9,6,3,0,0,0,0,0,0,0,0,0,1,1,0,0,0,0,0,0
,,Hispanic,68,32,36,0,65,30,35,0,3,2,1,0,0,0,0,0,0,0,0,0,0,0,0,0,0,0,0,0
,,Unknown,1,1,0,0,1,1,0,0,0,0,0,0,0,0,0,0,0,0,0,0,0,0,0,0,0,0,0,0
,,Asian,27,12,15,0,27,12,15,0,0,0,0,0,0,0,0,0,0,0,0,0,0,0,0,0,0,0,0,0
,,Multiracial,8,4,4,0,7,3,4,0,1,1,0,0,0,0,0,0,0,0,0,0,0,0,0,0,0,0,0,0
,Texas,All Ethnicities,10795,4136,6659,0,10504,4000,6504,0,262,122,140,0,2,1,1,0,1,0,1,0,25,13,12,0,2,0,2,0
,,White,5752,2215,3537,0,5557,2119,3438,0,170,83,87,0,2,1,1,0,1,0,1,0,21,12,9,0,1,0,1,0
,,Black,1046,424,622,0,1036,418,618,0,10,6,4,0,0,0,0,0,0,0,0,0,0,0,0,0,0,0,0,0
,,Hispanic,3646,1359,2287,0,3583,1336,2247,0,59,22,37,0,0,0,0,0,0,0,0,0,4,1,3,0,1,0,1,0
,,Unknown,3,2,1,0,3,2,1,0,0,0,0,0,0,0,0,0,0,0,0,0,0,0,0,0,0,0,0,0
,,Asian,220,94,126,0,213,90,123,0,7,4,3,0,0,0,0,0,0,0,0,0,0,0,0,0,0,0,0,0
,,American Indian/Alaska Native,24,9,15,0,23,9,14,0,1,0,1,0,0,0,0,0,0,0,0,0,0,0,0,0,0,0,0,0
,,Pacific Islander,24,9,15,0,24,9,15,0,0,0,0,0,0,0,0,0,0,0,0,0,0,0,0,0,0,0,0,0
,,Multiracial,80,24,56,0,65,17,48,0,15,7,8,0,0,0,0,0,0,0,0,0,0,0,0,0,0,0,0,0
,Utah,All Ethnicities,1769,802,967,0,1700,770,930,0,63,28,35,0,1,1,0,0,0,0,0,0,5,3,2,0,0,0,0,0
,,White,1594,722,872,0,1529,691,838,0,60,27,33,0,1,1,0,0,0,0,0,0,4,3,1,0,0,0,0,0
,,Black,8,3,5,0,7,3,4,0,0,0,0,0,0,0,0,0,0,0,0,0,1,0,1,0,0,0,0,0
,,Hispanic,115,56,59,0,114,56,58,0,1,0,1,0,0,0,0,0,0,0,0,0,0,0,0,0,0,0,0,0
,,Unknown,1,0,1,0,1,0,1,0,0,0,0,0,0,0,0,0,0,0,0,0,0,0,0,0,0,0,0,0
,,Asian,20,10,10,0,19,10,9,0,1,0,1,0,0,0,0,0,0,0,0,0,0,0,0,0,0,0,0,0
,,American Indian/Alaska Native,11,2,9,0,11,2,9,0,0,0,0,0,0,0,0,0,0,0,0,0,0,0,0,0,0,0,0,0
,,Pacific Islander,9,6,3,0,8,5,3,0,1,1,0,0,0,0,0,0,0,0,0,0,0,0,0,0,0,0,0,0
,,Multiracial,11,3,8,0,11,3,8,0,0,0,0,0,0,0,0,0,0,0,0,0,0,0,0,0,0,0,0,0
,Vermont,All Ethnicities,400,159,241,0,365,141,224,0,34,17,17,0,0,0,0,0,0,0,0,0,1,1,0,0,0,0,0,0
,,White,388,154,234,0,354,136,218,0,33,17,16,0,0,0,0,0,0,0,0,0,1,1,0,0,0,0,0,0
,,Black,3,1,2,0,3,1,2,0,0,0,0,0,0,0,0,0,0,0,0,0,0,0,0,0,0,0,0,0
,,Hispanic,7,4,3,0,7,4,3,0,0,0,0,0,0,0,0,0,0,0,0,0,0,0,0,0,0,0,0,0
,,Asian,1,0,1,0,0,0,0,0,1,0,1,0,0,0,0,0,0,0,0,0,0,0,0,0,0,0,0,0
,,Pacific Islander,1,0,1,0,1,0,1,0,0,0,0,0,0,0,0,0,0,0,0,0,0,0,0,0,0,0,0,0
,Virginia,All Ethnicities,5033,2108,2925,0,4734,1940,2794,0,285,158,127,0,1,0,1,0,1,0,1,0,10,9,1,0,3,1,2,0
,,White,3468,1435,2033,0,3207,1295,1912,0,249,131,118,0,1,0,1,0,0,0,0,0,10,9,1,0,1,0,1,0
,,,,,,,,,,,,,,,,,,,,,,,,,,,,,,
,,,,,,,,,,,,,,,,,,,,,,,,,,,,,,
,,Black,1102,461,641,0,1081,445,636,0,20,15,5,0,0,0,0,0,0,0,0,0,0,0,0,0,1,1,0,0
,,Hispanic,234,102,132,0,221,93,128,0,12,9,3,0,0,0,0,0,1,0,1,0,0,0,0,0,1,0,1,0
,,Asian,185,89,96,0,182,87,95,0,3,2,1,0,0,0,0,0,0,0,0,0,0,0,0,0,0,0,0,0
,,American Indian/Alaska Native,13,6,7,0,13,6,7,0,0,0,0,0,0,0,0,0,0,0,0,0,0,0,0,0,0,0,0,0
,,Pacific Islander,10,6,4,0,10,6,4,0,0,0,0,0,0,0,0,0,0,0,0,0,0,0,0,0,0,0,0,0
,,Multiracial,21,9,12,0,20,8,12,0,1,1,0,0,0,0,0,0,0,0,0,0,0,0,0,0,0,0,0,0
,Washington,All Ethnicities,2945,1114,1831,0,2868,1077,1791,0,67,34,33,0,3,0,3,0,0,0,0,0,7,3,4,0,0,0,0,0
,,White,2479,903,1576,0,2409,869,1540,0,60,31,29,0,3,0,3,0,0,0,0,0,7,3,4,0,0,0,0,0
,,Black,102,48,54,0,100,46,54,0,2,2,0,0,0,0,0,0,0,0,0,0,0,0,0,0,0,0,0,0
,,Hispanic,167,83,84,0,166,83,83,0,1,0,1,0,0,0,0,0,0,0,0,0,0,0,0,0,0,0,0,0
,,Unknown,1,0,1,0,1,0,1,0,0,0,0,0,0,0,0,0,0,0,0,0,0,0,0,0,0,0,0,0
,,Asian,113,49,64,0,110,48,62,0,3,1,2,0,0,0,0,0,0,0,0,0,0,0,0,0,0,0,0,0
,,American Indian/Alaska Native,24,7,17,0,24,7,17,0,0,0,0,0,0,0,0,0,0,0,0,0,0,0,0,0,0,0,0,0
,,Pacific Islander,21,11,10,0,21,11,10,0,0,0,0,0,0,0,0,0,0,0,0,0,0,0,0,0,0,0,0,0
,,Multiracial,38,13,25,0,37,13,24,0,1,0,1,0,0,0,0,0,0,0,0,0,0,0,0,0,0,0,0,0
,West Virginia,All Ethnicities,826,309,517,0,745,269,476,0,78,39,39,0,0,0,0,0,2,1,1,0,2,1,1,0,0,0,0,0
,,White,783,290,493,0,704,252,452,0,76,37,39,0,0,0,0,0,2,1,1,0,2,1,1,0,0,0,0,0
,,Black,32,15,17,0,32,15,17,0,0,0,0,0,0,0,0,0,0,0,0,0,0,0,0,0,0,0,0,0
,,Hispanic,4,1,3,0,3,0,3,0,1,1,0,0,0,0,0,0,0,0,0,0,0,0,0,0,0,0,0,0
,,Asian,5,2,3,0,4,1,3,0,1,1,0,0,0,0,0,0,0,0,0,0,0,0,0,0,0,0,0,0
,,Multiracial,2,1,1,0,2,1,1,0,0,0,0,0,0,0,0,0,0,0,0,0,0,0,0,0,0,0,0,0
,Wisconsin,All Ethnicities,3981,1565,2416,0,3873,1520,2353,0,97,41,56,0,0,0,0,0,5,3,2,0,10,3,7,0,0,0,0,0
,,White,3614,1401,2213,0,3516,1361,2155,0,87,36,51,0,0,0,0,0,5,3,2,0,10,3,7,0,0,0,0,0
,,Black,156,75,81,0,152,74,78,0,4,1,3,0,0,0,0,0,0,0,0,0,0,0,0,0,0,0,0,0
,,Hispanic,107,46,61,0,104,44,60,0,3,2,1,0,0,0,0,0,0,0,0,0,0,0,0,0,0,0,0,0
,,Unknown,2,1,1,0,2,1,1,0,0,0,0,0,0,0,0,0,0,0,0,0,0,0,0,0,0,0,0,0
,,Asian,38,15,23,0,37,14,23,0,1,1,0,0,0,0,0,0,0,0,0,0,0,0,0,0,0,0,0,0
,,American Indian/Alaska Native,48,20,28,0,46,19,27,0,2,1,1,0,0,0,0,0,0,0,0,0,0,0,0,0,0,0,0,0
,,Pacific Islander,2,1,1,0,2,1,1,0,0,0,0,0,0,0,0,0,0,0,0,0,0,0,0,0,0,0,0,0
,,Multiracial,14,6,8,0,14,6,8,0,0,0,0,0,0,0,0,0,0,0,0,0,0,0,0,0,0,0,0,0
,Wyoming,All Ethnicities,267,109,158,0,251,101,150,0,14,7,7,0,0,0,0,0,0,0,0,0,2,1,1,0,0,0,0,0
,,White,249,105,144,0,234,97,137,0,13,7,6,0,0,0,0,0,0,0,0,0,2,1,1,0,0,0,0,0
,,Hispanic,11,3,8,0,10,3,7,0,1,0,1,0,0,0,0,0,0,0,0,0,0,0,0,0,0,0,0,0
,,Asian,3,0,3,0,3,0,3,0,0,0,0,0,0,0,0,0,0,0,0,0,0,0,0,0,0,0,0,0
,,American Indian/Alaska Native,4,1,3,0,4,1,3,0,0,0,0,0,0,0,0,0,0,0,0,0,0,0,0,0,0,0,0,0
